# Actual words not in the dictionary
employable|employable
misspelling|misspelling
inconsistently|inconsistently

# Misc words
screenshot|screenshot

# Trademark names
psp|psp
playstation|playstation
xbox|xbox
x-box|x-box

# These are words from http://www.wordfrequency.info/files/entriesWithoutCollocates.txt
to|to
you|you
they|they
not|not
go|go
her|her
as|as
think|think
take|take
come|come
then|then
way|way
more|more
give|give
very|very
through|through
may|may
still|still
too|too
between|between
family|family
mean|mean
same|same
talk|talk
might|might
over|over
company|company
so|so
small|small
live|live
next|next
home|home
national|national
lot|lot
though|though
far|far
after|after
important|important
game|game
ever|ever
law|law
set|set
white|white
minute|minute
nothing|nothing
back|back
stop|stop
others|others
door|door
history|history
morning|morning
guy|guy
teacher|teacher
although|although
able|able
music|music
human|human
home|home
plan|plan
experience|experience
effect|effect
care|care
pass|pass
development|development
up|up
show|show
mind|mind
report|report
even|even
drive|drive
receive|receive
model|model
early|early
wear|wear
event|event
site|site
table|table
oil|oil
face|face
cover|cover
recent|recent
news|news
open|open
baby|baby
organization|organization
hair|hair
listen|listen
realize|realize
plant|plant
choice|choice
husband|husband
call|call
thousand|thousand
behavior|behavior
west|west
private|private
quickly|quickly
fill|fill
upon|upon
store|store
movement|movement
other|other
hot|hot
animal|animal
save|save
despite|despite
protect|protect
occur|occur
simple|simple
identify|identify
success|success
staff|staff
attack|attack
deal|deal
feeling|feeling
analysis|analysis
section|section
professor|professor
authority|authority
knowledge|knowledge
clearly|clearly
democratic|democratic
rather|rather
hang|hang
claim|claim
enjoy|enjoy
main|main
cell|cell
firm|firm
imagine|imagine
finish|finish
charge|charge
employee|employee
pain|pain
interview|interview
politics|politics
top|top
conference|conference
range|range
specific|specific
shoulder|shoulder
property|property
somebody|somebody
cause|cause
purpose|purpose
owner|owner
address|address
yard|yard
finger|finger
positive|positive
painting|painting
victim|victim
score|score
figure|figure
citizen|citizen
assume|assume
customer|customer
southern|southern
reform|reform
like|like
critical|critical
effective|effective
hurt|hurt
sky|sky
nine|nine
therefore|therefore
attend|attend
investigation|investigation
replace|replace
camp|camp
possibility|possibility
generally|generally
stick|stick
vision|vision
scale|scale
spot|spot
distance|distance
supposed|supposed
roll|roll
gold|gold
European|European
crowd|crowd
band|band
guard|guard
tool|tool
understanding|understanding
earn|earn
contribute|contribute
additional|additional
faith|faith
marry|marry
order|order
gather|gather
associate|associate
annual|annual
until|until
ignore|ignore
gift|gift
document|document
female|female
native|native
twice|twice
intelligence|intelligence
neighbor|neighbor
focus|focus
promise|promise
extend|extend
voter|voter
moral|moral
visit|visit
medicine|medicine
classroom|classroom
famous|famous
appropriate|appropriate
search|search
device|device
clean|clean
neck|neck
writing|writing
theater|theater
map|map
literature|literature
northern|northern
instruction|instruction
fourth|fourth
software|software
mental|mental
sugar|sugar
complex|complex
scientific|scientific
alone|alone
bear|bear
consequence|consequence
minority|minority
aid|aid
trail|trail
human|human
fear|fear
prime|prime
like|like
revenue|revenue
bridge|bridge
anymore|anymore
currently|currently
accident|accident
notion|notion
search|search
feature|feature
root|root
hardly|hardly
ad|ad
ought|ought
slow|slow
chief|chief
cat|cat
English|English
funny|funny
due|due
crazy|crazy
frequently|frequently
ancient|ancient
gender|gender
long|long
eliminate|eliminate
producer|producer
appeal|appeal
complain|complain
perception|perception
his|his
bond|bond
check|check
clear|clear
clean|clean
seriously|seriously
stretch|stretch
fashion|fashion
below|below
improvement|improvement
initial|initial
question|question
necessarily|necessarily
dance|dance
apart|apart
lack|lack
faculty|faculty
bomb|bomb
wheel|wheel
rural|rural
noise|noise
celebrate|celebrate
useful|useful
milk|milk
height|height
first|first
explanation|explanation
guilty|guilty
potential|potential
interaction|interaction
forever|forever
review|review
depression|depression
warning|warning
permit|permit
request|request
excellent|excellent
library|library
unable|unable
wash|wash
existing|existing
fairly|fairly
tea|tea
description|description
portion|portion
lake|lake
alcohol|alcohol
error|error
sand|sand
transition|transition
reply|reply
resistance|resistance
benefit|benefit
knife|knife
coat|coat
interview|interview
urge|urge
ordinary|ordinary
numerous|numerous
moreover|moreover
sauce|sauce
advance|advance
illness|illness
juice|juice
another|another
boss|boss
enhance|enhance
entry|entry
mood|mood
Asian|Asian
concentrate|concentrate
approximately|approximately
round|round
commission|commission
capable|capable
pray|pray
objective|objective
mixture|mixture
dimension|dimension
shape|shape
implication|implication
recognition|recognition
corn|corn
salary|salary
pretty|pretty
literally|literally
exhibition|exhibition
date|date
smoke|smoke
fifth|fifth
weigh|weigh
elementary|elementary
channel|channel
roll|roll
Palestinian|Palestinian
giant|giant
specialist|specialist
quietly|quietly
shell|shell
onion|onion
criteria|criteria
arise|arise
normally|normally
activist|activist
corporation|corporation
barrier|barrier
classic|classic
advocate|advocate
distant|distant
Italian|Italian
spin|spin
super|super
bunch|bunch
burden|burden
communicate|communicate
disagree|disagree
bear|bear
cabinet|cabinet
literary|literary
overcome|overcome
cousin|cousin
adviser|adviser
slave|slave
expansion|expansion
tight|tight
conservative|conservative
interpret|interpret
fiction|fiction
senator|senator
boundary|boundary
raw|raw
testify|testify
advanced|advanced
delivery|delivery
attractive|attractive
regularly|regularly
unknown|unknown
transfer|transfer
craft|craft
episode|episode
shortly|shortly
assault|assault
headquarters|headquarters
shelter|shelter
defensive|defensive
spot|spot
convert|convert
appeal|appeal
violate|violate
vital|vital
poet|poet
Irish|Irish
significance|significance
grandfather|grandfather
garlic|garlic
doubt|doubt
ongoing|ongoing
fellow|fellow
shade|shade
palm|palm
efficient|efficient
closer|closer
besides|besides
limitation|limitation
incredible|incredible
educate|educate
tendency|tendency
efficiency|efficiency
helpful|helpful
surprise|surprise
trick|trick
proposed|proposed
tennis|tennis
purchase|purchase
suspect|suspect
provider|provider
punishment|punishment
request|request
principal|principal
Palestinian|Palestinian
motor|motor
orange|orange
cabin|cabin
pine|pine
absolute|absolute
appoint|appoint
shit|shit
naked|naked
fly|fly
flame|flame
institutional|institutional
furthermore|furthermore
weekly|weekly
measurement|measurement
wise|wise
medium|medium
firm|firm
basket|basket
ugly|ugly
cookie|cookie
awful|awful
killing|killing
transformation|transformation
adequate|adequate
high|high
prescription|prescription
consensus|consensus
courage|courage
clue|clue
sacred|sacred
uncle|uncle
cool|cool
lap|lap
makeup|makeup
favor|favor
compose|compose
adolescent|adolescent
gentle|gentle
fit|fit
interrupt|interrupt
stem|stem
jeans|jeans
compound|compound
subtle|subtle
cry|cry
final|final
export|export
net|net
exclude|exclude
favor|favor
excuse|excuse
reverse|reverse
reliable|reliable
occasional|occasional
confuse|confuse
plead|plead
implementation|implementation
render|render
lens|lens
fraud|fraud
rat|rat
monster|monster
rip|rip
top|top
nightmare|nightmare
possession|possession
project|project
warrior|warrior
outdoor|outdoor
past|past
domain|domain
walking|walking
aim|aim
welcome|welcome
peaceful|peaceful
simultaneously|simultaneously
await|await
virtual|virtual
towel|towel
blue|blue
sweat|sweat
research|research
wherever|wherever
accommodate|accommodate
mandate|mandate
short|short
currency|currency
turkey|turkey
compromise|compromise
fork|fork
finish|finish
pleasant|pleasant
frozen|frozen
pension|pension
bounce|bounce
dedicate|dedicate
ship|ship
transaction|transaction
noon|noon
anxious|anxious
poster|poster
magic|magic
jazz|jazz
evil|evil
punish|punish
guidance|guidance
gym|gym
destination|destination
bath|bath
bold|bold
age|age
realm|realm
pizza|pizza
bias|bias
entity|entity
servant|servant
trail|trail
starter|starter
value|value
productive|productive
steep|steep
angel|angel
disappointed|disappointed
enroll|enroll
stumble|stumble
hook|hook
cooperate|cooperate
seal|seal
lately|lately
undertake|undertake
tribal|tribal
way|way
elder|elder
Greek|Greek
juror|juror
loyalty|loyalty
stiff|stiff
alleged|alleged
bow|bow
sword|sword
carpet|carpet
dilemma|dilemma
improved|improved
associated|associated
steam|steam
unite|unite
statute|statute
symbolic|symbolic
root|root
mixed|mixed
grasp|grasp
rent|rent
afterward|afterward
reliability|reliability
thigh|thigh
ideological|ideological
neutral|neutral
conspiracy|conspiracy
star|star
ministry|ministry
manipulate|manipulate
puzzle|puzzle
earthquake|earthquake
creativity|creativity
jump|jump
syndrome|syndrome
presumably|presumably
dissolve|dissolve
expected|expected
cast|cast
fortunately|fortunately
flexibility|flexibility
equivalent|equivalent
sibling|sibling
soap|soap
passing|passing
franchise|franchise
correctly|correctly
heal|heal
sensation|sensation
pro|pro
comprise|comprise
dam|dam
patent|patent
disabled|disabled
associate|associate
case|case
attendance|attendance
stimulate|stimulate
stance|stance
proclaim|proclaim
ideal|ideal
sack|sack
shrink|shrink
rational|rational
vocal|vocal
deploy|deploy
chunk|chunk
migration|migration
wound|wound
robot|robot
likewise|likewise
perceived|perceived
joke|joke
added|added
sneak|sneak
legally|legally
pile|pile
liberal|liberal
mineral|mineral
equality|equality
carrot|carrot
isolated|isolated
sponsor|sponsor
chill|chill
vendor|vendor
auction|auction
comparable|comparable
interval|interval
strain|strain
bulk|bulk
liver|liver
goat|goat
cruise|cruise
part|part
impulse|impulse
poke|poke
dancing|dancing
light|light
distinctive|distinctive
straw|straw
objection|objection
denial|denial
screw|screw
mention|mention
grape|grape
clay|clay
homework|homework
molecule|molecule
freely|freely
accountability|accountability
spark|spark
bucket|bucket
marble|marble
explicit|explicit
neighboring|neighboring
harvest|harvest
spy|spy
ridge|ridge
specify|specify
swell|swell
sudden|sudden
tile|tile
foreigner|foreigner
plea|plea
bulb|bulb
seller|seller
boring|boring
warehouse|warehouse
nationwide|nationwide
stereotype|stereotype
pistol|pistol
website|website
bizarre|bizarre
scrutiny|scrutiny
hunt|hunt
videotape|videotape
march|march
congregation|congregation
marijuana|marijuana
rejection|rejection
autumn|autumn
objective|objective
surrender|surrender
inspect|inspect
caller|caller
voice|voice
sketch|sketch
combat|combat
ward|ward
reasonably|reasonably
knot|knot
creator|creator
glow|glow
creep|creep
farming|farming
inability|inability
mandatory|mandatory
bass|bass
mature|mature
between|between
breakdown|breakdown
spin|spin
taxi|taxi
loving|loving
passionate|passionate
hood|hood
charming|charming
adaptation|adaptation
double|double
sympathetic|sympathetic
litigation|litigation
choke|choke
delegate|delegate
affordable|affordable
robe|robe
pin|pin
acute|acute
gown|gown
persistent|persistent
architectural|architectural
endangered|endangered
nationally|nationally
anything|anything
rap|rap
established|established
rear|rear
attain|attain
urgent|urgent
confine|confine
strand|strand
bead|bead
hazardous|hazardous
merge|merge
grind|grind
shotgun|shotgun
transplant|transplant
evolutionary|evolutionary
champagne|champagne
demon|demon
invoke|invoke
theirs|theirs
proposition|proposition
handling|handling
guerrilla|guerrilla
parenting|parenting
descent|descent
waiter|waiter
downstairs|downstairs
financially|financially
tax|tax
push|push
contrary|contrary
prey|prey
editorial|editorial
absent|absent
modification|modification
fireplace|fireplace
frighten|frighten
furious|furious
grade|grade
Turkish|Turkish
unidentified|unidentified
utterly|utterly
microphone|microphone
magical|magical
socialist|socialist
inject|inject
supervise|supervise
newcomer|newcomer
con|con
precedent|precedent
calf|calf
boxing|boxing
alert|alert
ashamed|ashamed
astronaut|astronaut
embarrassing|embarrassing
intimacy|intimacy
permanently|permanently
jail|jail
broth|broth
delegation|delegation
spark|spark
liquor|liquor
span|span
cube|cube
preacher|preacher
sunset|sunset
echo|echo
sweeping|sweeping
legitimacy|legitimacy
deed|deed
closure|closure
luxury|luxury
frightened|frightened
playground|playground
brow|brow
par|par
governmental|governmental
graphic|graphic
parallel|parallel
incidence|incidence
wan|wan
anchor|anchor
setup|setup
printer|printer
nitrogen|nitrogen
circulate|circulate
maximize|maximize
urge|urge
say|say
drain|drain
leak|leak
postwar|postwar
flush|flush
predominantly|predominantly
accountant|accountant
diner|diner
artery|artery
nonsense|nonsense
dressing|dressing
complicate|complicate
lounge|lounge
daylight|daylight
wary|wary
parallel|parallel
prostitute|prostitute
intake|intake
hedge|hedge
murmur|murmur
gauge|gauge
injustice|injustice
soy|soy
reunion|reunion
jewel|jewel
coat|coat
albeit|albeit
dial|dial
controller|controller
local|local
activate|activate
caregiver|caregiver
socioeconomic|socioeconomic
operational|operational
wide|wide
multiply|multiply
notorious|notorious
entail|entail
fix|fix
heroic|heroic
tomb|tomb
frustrating|frustrating
protester|protester
compact|compact
tug|tug
saddle|saddle
prone|prone
hammer|hammer
lazy|lazy
Greek|Greek
caution|caution
coffin|coffin
disturbance|disturbance
magnet|magnet
seasonal|seasonal
considering|considering
stripe|stripe
tee|tee
decrease|decrease
opposite|opposite
curl|curl
wage|wage
chuckle|chuckle
steering|steering
usage|usage
embargo|embargo
antique|antique
fertilizer|fertilizer
breed|breed
handy|handy
differentiate|differentiate
Brazilian|Brazilian
situate|situate
wrestle|wrestle
devastate|devastate
darling|darling
deployment|deployment
petty|petty
wrap|wrap
bureaucratic|bureaucratic
icy|icy
deviation|deviation
governance|governance
skeleton|skeleton
marked|marked
nurse|nurse
consulting|consulting
renewal|renewal
keen|keen
archive|archive
pillar|pillar
uneasy|uneasy
sporting|sporting
retention|retention
beneficiary|beneficiary
Bosnian|Bosnian
policymaker|policymaker
asthma|asthma
spontaneous|spontaneous
necklace|necklace
manifestation|manifestation
rivalry|rivalry
oval|oval
hurdle|hurdle
propel|propel
kind|kind
undo|undo
sergeant|sergeant
deter|deter
privatization|privatization
stark|stark
promptly|promptly
cheer|cheer
elicit|elicit
inquire|inquire
elevation|elevation
backdrop|backdrop
scoring|scoring
alpha|alpha
unveil|unveil
accepted|accepted
bark|bark
unlimited|unlimited
circular|circular
hillside|hillside
allocate|allocate
mourn|mourn
paradox|paradox
discriminate|discriminate
displace|displace
gradual|gradual
angler|angler
dating|dating
paradise|paradise
hum|hum
desktop|desktop
ammunition|ammunition
steroids|steroids
answering|answering
pluck|pluck
roommate|roommate
sound|sound
secondly|secondly
stock|stock
divide|divide
loosely|loosely
squash|squash
elusive|elusive
skepticism|skepticism
nucleus|nucleus
brightly|brightly
conform|conform
admiration|admiration
overview|overview
apparatus|apparatus
extensively|extensively
inequality|inequality
preschool|preschool
coherent|coherent
autobiography|autobiography
intensely|intensely
vigorously|vigorously
sunglasses|sunglasses
vampire|vampire
periodically|periodically
blunt|blunt
emperor|emperor
outraged|outraged
lodge|lodge
preceding|preceding
pave|pave
infectious|infectious
heated|heated
informant|informant
assault|assault
spy|spy
abusive|abusive
embarrass|embarrass
daytime|daytime
silence|silence
tribunal|tribunal
obesity|obesity
milky|milky
militant|militant
plug|plug
space|space
pearl|pearl
subscriber|subscriber
Baptist|Baptist
crumb|crumb
batter|batter
allegiance|allegiance
freezer|freezer
subsidize|subsidize
throne|throne
floating|floating
burger|burger
visibility|visibility
incorrect|incorrect
baggage|baggage
focal|focal
veil|veil
severity|severity
extraordinarily|extraordinarily
openness|openness
ginger|ginger
furnish|furnish
knowledgeable|knowledgeable
controlled|controlled
examiner|examiner
multimedia|multimedia
prolonged|prolonged
raft|raft
spike|spike
negatively|negatively
alternate|alternate
veto|veto
plight|plight
sickness|sickness
Madame|Madame
peek|peek
nap|nap
frantic|frantic
impatient|impatient
cautiously|cautiously
daunting|daunting
eagerly|eagerly
rainy|rainy
pose|pose
persistence|persistence
desperation|desperation
librarian|librarian
vastly|vastly
validate|validate
Roman|Roman
preview|preview
quick|quick
crunch|crunch
foe|foe
capture|capture
troubling|troubling
catastrophic|catastrophic
whip|whip
impact|impact
collide|collide
directive|directive
creamy|creamy
harmless|harmless
wade|wade
enjoyment|enjoyment
impeachment|impeachment
dictatorship|dictatorship
lessen|lessen
parliamentary|parliamentary
pair|pair
cellar|cellar
linkage|linkage
masterpiece|masterpiece
pronounced|pronounced
multinational|multinational
discern|discern
insult|insult
paid|paid
unsuccessful|unsuccessful
uprising|uprising
intentionally|intentionally
sunshine|sunshine
newborn|newborn
superiority|superiority
bum|bum
adulthood|adulthood
rehearse|rehearse
bust|bust
fiercely|fiercely
ceramic|ceramic
brighten|brighten
amongst|amongst
painfully|painfully
specification|specification
pier|pier
onstage|onstage
resonate|resonate
breach|breach
channel|channel
glacier|glacier
chair|chair
succumb|succumb
forearm|forearm
wink|wink
baked|baked
catalyst|catalyst
Episcopal|Episcopal
confide|confide
hen|hen
casting|casting
shaky|shaky
executive|executive
novelty|novelty
schooling|schooling
grouping|grouping
dial|dial
shower|shower
meaningless|meaningless
sociology|sociology
clearing|clearing
detainee|detainee
wavelength|wavelength
surf|surf
computerized|computerized
flicker|flicker
delete|delete
physiological|physiological
successive|successive
lousy|lousy
vow|vow
nostalgia|nostalgia
preclude|preclude
infected|infected
mustache|mustache
jealousy|jealousy
drastic|drastic
cookbook|cookbook
imbalance|imbalance
restructure|restructure
indoors|indoors
scenery|scenery
chill|chill
ragged|ragged
disconnect|disconnect
converge|converge
deception|deception
famine|famine
cycling|cycling
lighter|lighter
dwelling|dwelling
Dominican|Dominican
hack|hack
patiently|patiently
abnormal|abnormal
bamboo|bamboo
interception|interception
stainless|stainless
synthesis|synthesis
monumental|monumental
reviewer|reviewer
superpower|superpower
playing|playing
mortar|mortar
spear|spear
overtime|overtime
aroma|aroma
buffet|buffet
cruelty|cruelty
take|take
mingle|mingle
floral|floral
compression|compression
litter|litter
synagogue|synagogue
rotten|rotten
vodka|vodka
vie|vie
footprint|footprint
abstraction|abstraction
commanding|commanding
rap|rap
bodily|bodily
cloak|cloak
cumulative|cumulative
unconstitutional|unconstitutional
accumulation|accumulation
flare|flare
unpopular|unpopular
parasite|parasite
noticeable|noticeable
curiously|curiously
group|group
mystical|mystical
referee|referee
Hispanic|Hispanic
dissatisfaction|dissatisfaction
bargain|bargain
thread|thread
guided|guided
doctorate|doctorate
foreground|foreground
vengeance|vengeance
heavyweight|heavyweight
influx|influx
phony|phony
absorption|absorption
fig|fig
coax|coax
affective|affective
package|package
minus|minus
commercially|commercially
monarch|monarch
raise|raise
paranoid|paranoid
relish|relish
eyelid|eyelid
visualize|visualize
mock|mock
nanny|nanny
groom|groom
glimpse|glimpse
terminal|terminal
automotive|automotive
utter|utter
reunite|reunite
battalion|battalion
dizzy|dizzy
raid|raid
vomit|vomit
endlessly|endlessly
makeshift|makeshift
facet|facet
freelance|freelance
chuck|chuck
subside|subside
internally|internally
graffiti|graffiti
rig|rig
mundane|mundane
lest|lest
etch|etch
dangerously|dangerously
liberalization|liberalization
persecution|persecution
tick|tick
longevity|longevity
insignificant|insignificant
wonderfully|wonderfully
excavation|excavation
boot|boot
bedside|bedside
envy|envy
token|token
frail|frail
rash|rash
shrug|shrug
gunshot|gunshot
sever|sever
participating|participating
freak|freak
waiting|waiting
swarm|swarm
deterioration|deterioration
experimentation|experimentation
mailbox|mailbox
fend|fend
affected|affected
jelly|jelly
lavish|lavish
midwestern|midwestern
hamper|hamper
damned|damned
banquet|banquet
equilibrium|equilibrium
fireman|fireman
upheaval|upheaval
fluorescent|fluorescent
anthrax|anthrax
enclave|enclave
nuance|nuance
underwater|underwater
binding|binding
rapper|rapper
cartridge|cartridge
Indonesian|Indonesian
licensed|licensed
cramped|cramped
Arabic|Arabic
gala|gala
cranberry|cranberry
per|per
alphabet|alphabet
expansive|expansive
handwriting|handwriting
Martian|Martian
covered|covered
Haitian|Haitian
evidence|evidence
unreasonable|unreasonable
affinity|affinity
gaming|gaming
stray|stray
replica|replica
advancing|advancing
shoreline|shoreline
aesthetics|aesthetics
tug|tug
blind|blind
terminology|terminology
optics|optics
hastily|hastily
warden|warden
relay|relay
unnoticed|unnoticed
breadth|breadth
orphanage|orphanage
muted|muted
unilateral|unilateral
caring|caring
bowel|bowel
tenor|tenor
flavor|flavor
ruthless|ruthless
losing|losing
motorist|motorist
broom|broom
bestow|bestow
gloom|gloom
brief|brief
curve|curve
relinquish|relinquish
dismal|dismal
notch|notch
donkey|donkey
polish|polish
anthem|anthem
tickle|tickle
traveling|traveling
jockey|jockey
sight|sight
ashore|ashore
persuasion|persuasion
ensue|ensue
wed|wed
scoop|scoop
monarchy|monarchy
mailing|mailing
malpractice|malpractice
mower|mower
limousine|limousine
luminous|luminous
snowy|snowy
meager|meager
rusty|rusty
grunt|grunt
afflict|afflict
skater|skater
managed|managed
disdain|disdain
oppressive|oppressive
swoop|swoop
parachute|parachute
faintly|faintly
hiker|hiker
intimidation|intimidation
prom|prom
hairy|hairy
interpretive|interpretive
deterrent|deterrent
pioneering|pioneering
nope|nope
checkpoint|checkpoint
postseason|postseason
cast|cast
receptive|receptive
harness|harness
dissipate|dissipate
pediatrician|pediatrician
ensuing|ensuing
bidding|bidding
tracking|tracking
manure|manure
same|same
called|called
flux|flux
warhead|warhead
wreath|wreath
epic|epic
scorer|scorer
blackness|blackness
impaired|impaired
divisive|divisive
sensational|sensational
pertinent|pertinent
unanswered|unanswered
downplay|downplay
connected|connected
tart|tart
equitable|equitable
worldview|worldview
skate|skate
frying|frying
runaway|runaway
remedy|remedy
powdered|powdered
overlap|overlap
lame|lame
parrot|parrot
thump|thump
yeast|yeast
flowing|flowing
promised|promised
hegemony|hegemony
displaced|displaced
convergence|convergence
cosmetics|cosmetics
continual|continual
bubble|bubble
revert|revert
hospitalize|hospitalize
stimulating|stimulating
proactive|proactive
approved|approved
mosaic|mosaic
squadron|squadron
grope|grope
brown|brown
gust|gust
vain|vain
profile|profile
minced|minced
metric|metric
retarded|retarded
crown|crown
upright|upright
electronically|electronically
proficiency|proficiency
analogous|analogous
accreditation|accreditation
sect|sect
handicapped|handicapped
cloudy|cloudy
precipitate|precipitate
ho|ho
sixteenth|sixteenth
inspiring|inspiring
cheerleader|cheerleader
dissatisfied|dissatisfied
curricular|curricular
sealed|sealed
projector|projector
nicotine|nicotine
quaint|quaint
thirsty|thirsty
school|school
aquarium|aquarium
winery|winery
thoughtfully|thoughtfully
headnote|headnote
ally|ally
rosemary|rosemary
trim|trim
sow|sow
getaway|getaway
stoop|stoop
disintegrate|disintegrate
forestry|forestry
Belgian|Belgian
stat|stat
entrust|entrust
detach|detach
reorganization|reorganization
mediocre|mediocre
beacon|beacon
roast|roast
swell|swell
yen|yen
gracefully|gracefully
pride|pride
margarine|margarine
preserve|preserve
batting|batting
nostalgic|nostalgic
humanities|humanities
sewing|sewing
diarrhea|diarrhea
Kuwaiti|Kuwaiti
confound|confound
compact|compact
surplus|surplus
eclipse|eclipse
amnesty|amnesty
forcefully|forcefully
deli|deli
delicately|delicately
revitalize|revitalize
electromagnetic|electromagnetic
ornate|ornate
hum|hum
stronghold|stronghold
expend|expend
redesign|redesign
arch|arch
stylistic|stylistic
special|special
emigrate|emigrate
wiggle|wiggle
lore|lore
investing|investing
closeness|closeness
subgroup|subgroup
updated|updated
induction|induction
stash|stash
dialect|dialect
sharing|sharing
flyer|flyer
attributable|attributable
mare|mare
inconvenience|inconvenience
foothill|foothill
recurrence|recurrence
clothe|clothe
twirl|twirl
viability|viability
distorted|distorted
ancestry|ancestry
accelerated|accelerated
dweller|dweller
mussels|mussels
pilot|pilot
gobble|gobble
unprepared|unprepared
cheerfully|cheerfully
leafy|leafy
reorganize|reorganize
powerfully|powerfully
wrong|wrong
gutter|gutter
adventurous|adventurous
plutonium|plutonium
uncanny|uncanny
buy|buy
eject|eject
forgiving|forgiving
mute|mute
watermelon|watermelon
stairwell|stairwell
remarry|remarry
intrusive|intrusive
methodological|methodological
cognition|cognition
leukemia|leukemia
unnamed|unnamed
defective|defective
conducive|conducive
reference|reference
veggie|veggie
articulation|articulation
steep|steep
shrewd|shrewd
thicket|thicket
magistrate|magistrate
ooze|ooze
shallot|shallot
verification|verification
fancy|fancy
quad|quad
antisocial|antisocial
hanger|hanger
refute|refute
knowingly|knowingly
garner|garner
militarily|militarily
canister|canister
bedding|bedding
antioxidant|antioxidant
illumination|illumination
saturate|saturate
whereabouts|whereabouts
divergent|divergent
inward|inward
woodland|woodland
restored|restored
heady|heady
shame|shame
cashier|cashier
espionage|espionage
wildflower|wildflower
bogus|bogus
further|further
insistent|insistent
overrun|overrun
riding|riding
unpublished|unpublished
dichotomy|dichotomy
bog|bog
concerted|concerted
fieldwork|fieldwork
incorporation|incorporation
taboo|taboo
symposium|symposium
homelessness|homelessness
creepy|creepy
doze|doze
national|national
adversity|adversity
deserving|deserving
primate|primate
roadblock|roadblock
assertive|assertive
insert|insert
maternity|maternity
tabloid|tabloid
rodeo|rodeo
offensive|offensive
abnormality|abnormality
trickle|trickle
blank|blank
secretive|secretive
commando|commando
hospitalization|hospitalization
yarn|yarn
logically|logically
barley|barley
manifest|manifest
deceptive|deceptive
balancing|balancing
coherence|coherence
treatise|treatise
legitimize|legitimize
intertwine|intertwine
replay|replay
enlighten|enlighten
troupe|troupe
pat|pat
shin|shin
milieu|milieu
unconditional|unconditional
spaceship|spaceship
constant|constant
dashboard|dashboard
blush|blush
conscientious|conscientious
threatened|threatened
Caucasian|Caucasian
touring|touring
fidelity|fidelity
depot|depot
fastball|fastball
commotion|commotion
airwaves|airwaves
outward|outward
squander|squander
etiquette|etiquette
shutdown|shutdown
impatiently|impatiently
shrink|shrink
intermediary|intermediary
fraught|fraught
dribble|dribble
tally|tally
lash|lash
mayonnaise|mayonnaise
candlelight|candlelight
groundwork|groundwork
midwife|midwife
lug|lug
protrude|protrude
ore|ore
handbag|handbag
interplay|interplay
guidebook|guidebook
optimist|optimist
turning|turning
feasibility|feasibility
cub|cub
unprotected|unprotected
essential|essential
enclosed|enclosed
sprint|sprint
clandestine|clandestine
mysteriously|mysteriously
distraught|distraught
bullying|bullying
otter|otter
bagel|bagel
stratum|stratum
reconnaissance|reconnaissance
leopard|leopard
infertility|infertility
chilled|chilled
scorn|scorn
contracting|contracting
mitigation|mitigation
paramilitary|paramilitary
compulsive|compulsive
bait|bait
bearer|bearer
moan|moan
plumber|plumber
latent|latent
processed|processed
workstation|workstation
skew|skew
communist|communist
summertime|summertime
creed|creed
amino|amino
arcade|arcade
handout|handout
lapel|lapel
masked|masked
fender|fender
stinging|stinging
deterrence|deterrence
tonic|tonic
sexist|sexist
inequity|inequity
morgue|morgue
vascular|vascular
replenish|replenish
biomedical|biomedical
incarceration|incarceration
quirk|quirk
gorge|gorge
regal|regal
magnesium|magnesium
tubing|tubing
potassium|potassium
untreated|untreated
lifeless|lifeless
neutrality|neutrality
glitter|glitter
incidental|incidental
aerobics|aerobics
kickoff|kickoff
intermittent|intermittent
illiterate|illiterate
buff|buff
horribly|horribly
sentencing|sentencing
freestyle|freestyle
pending|pending
airway|airway
snarl|snarl
hunch|hunch
yearning|yearning
blink|blink
oblivion|oblivion
evict|evict
concealed|concealed
demo|demo
swinging|swinging
sentencing|sentencing
mounted|mounted
taco|taco
diffuse|diffuse
sunflower|sunflower
meditate|meditate
blitz|blitz
limp|limp
elite|elite
excitedly|excitedly
marinade|marinade
dazzle|dazzle
jargon|jargon
trance|trance
objectively|objectively
pedagogy|pedagogy
healthful|healthful
carnival|carnival
hunk|hunk
cartilage|cartilage
connector|connector
punt|punt
bombardment|bombardment
duel|duel
steroid|steroid
captor|captor
propeller|propeller
buck|buck
silicone|silicone
better|better
westward|westward
ta|ta
adversely|adversely
puberty|puberty
tumultuous|tumultuous
bumpy|bumpy
steamy|steamy
enlightenment|enlightenment
fright|fright
stagger|stagger
logger|logger
peg|peg
pawn|pawn
naughty|naughty
replay|replay
utensil|utensil
immaculate|immaculate
rumor|rumor
insightful|insightful
checkup|checkup
apprenticeship|apprenticeship
registry|registry
drape|drape
accomplice|accomplice
colossal|colossal
vaginal|vaginal
airfield|airfield
assailant|assailant
disregard|disregard
piercing|piercing
sneeze|sneeze
arsenic|arsenic
primacy|primacy
permissible|permissible
fondly|fondly
twisting|twisting
epoch|epoch
cork|cork
wondrous|wondrous
chap|chap
egregious|egregious
ambush|ambush
baptize|baptize
cherished|cherished
paraphrase|paraphrase
localized|localized
immortality|immortality
dish|dish
spook|spook
juvenile|juvenile
cornmeal|cornmeal
midlife|midlife
driving|driving
wasteful|wasteful
borderline|borderline
postsecondary|postsecondary
listed|listed
cartoonist|cartoonist
droplet|droplet
poorly|poorly
precedence|precedence
bag|bag
inertia|inertia
reindeer|reindeer
agitated|agitated
Amish|Amish
contraceptive|contraceptive
bigotry|bigotry
auspice|auspice
inexplicable|inexplicable
oppress|oppress
cobalt|cobalt
reparation|reparation
transistor|transistor
miscarriage|miscarriage
sling|sling
scapegoat|scapegoat
mindless|mindless
shellfish|shellfish
trustworthy|trustworthy
immunization|immunization
recoil|recoil
fondness|fondness
khaki|khaki
embedded|embedded
standout|standout
prowl|prowl
discernible|discernible
nonpartisan|nonpartisan
extracurricular|extracurricular
uproar|uproar
manslaughter|manslaughter
wrinkle|wrinkle
covering|covering
personalized|personalized
fluency|fluency
jostle|jostle
eyelash|eyelash
hole|hole
computational|computational
stir|stir
mismanagement|mismanagement
increment|increment
behemoth|behemoth
in|in
nascent|nascent
fanfare|fanfare
psychotic|psychotic
deafening|deafening
asking|asking
beep|beep
bribery|bribery
pamper|pamper
sonic|sonic
nocturnal|nocturnal
yell|yell
stout|stout
dripping|dripping
cashmere|cashmere
dislodge|dislodge
darkly|darkly
overture|overture
spade|spade
toss|toss
musically|musically
fore|fore
juniper|juniper
repressed|repressed
inconvenient|inconvenient
spatula|spatula
hotline|hotline
valet|valet
pretext|pretext
bustle|bustle
mantel|mantel
residuals|residuals
communicator|communicator
veranda|veranda
mouth|mouth
Romanian|Romanian
distrust|distrust
shootout|shootout
endeavor|endeavor
ready|ready
mellow|mellow
starch|starch
informational|informational
oceanic|oceanic
plethora|plethora
porous|porous
attractiveness|attractiveness
distressed|distressed
glorify|glorify
sinful|sinful
lite|lite
padding|padding
stud|stud
deflate|deflate
gleam|gleam
brownie|brownie
homemaker|homemaker
benefactor|benefactor
interchange|interchange
allegory|allegory
propriety|propriety
pragmatism|pragmatism
artistry|artistry
piping|piping
strait|strait
convincingly|convincingly
retrace|retrace
divulge|divulge
aristocracy|aristocracy
wriggle|wriggle
cramp|cramp
font|font
apathy|apathy
vet|vet
bran|bran
penal|penal
reservist|reservist
tweed|tweed
filament|filament
mascara|mascara
awash|awash
gloved|gloved
safari|safari
transfix|transfix
abstain|abstain
nudity|nudity
reactionary|reactionary
tactile|tactile
wanting|wanting
abused|abused
mockery|mockery
eloquently|eloquently
well|well
rake|rake
out|out
erect|erect
jumble|jumble
fabled|fabled
maverick|maverick
unparalleled|unparalleled
fume|fume
inept|inept
nap|nap
witchcraft|witchcraft
indefinite|indefinite
visualization|visualization
deplore|deplore
orthopedic|orthopedic
whimper|whimper
CPU|CPU
zip|zip
codify|codify
morph|morph
bastion|bastion
glacial|glacial
disobedience|disobedience
itch|itch
meek|meek
tan|tan
warp|warp
ram|ram
dissuade|dissuade
omen|omen
crippling|crippling
ecologically|ecologically
gastrointestinal|gastrointestinal
elm|elm
personify|personify
swap|swap
beaded|beaded
index|index
snapper|snapper
chives|chives
widowed|widowed
conjunction|conjunction
sustenance|sustenance
labeled|labeled
manned|manned
caviar|caviar
unqualified|unqualified
overwhelmed|overwhelmed
retro|retro
canonical|canonical
symptomatic|symptomatic
anemia|anemia
lightweight|lightweight
mop|mop
terminally|terminally
irritable|irritable
phosphorus|phosphorus
conspicuously|conspicuously
intersperse|intersperse
pallet|pallet
gratefully|gratefully
playfully|playfully
admonition|admonition
inroads|inroads
monograph|monograph
overload|overload
simplified|simplified
plenty|plenty
contrary|contrary
burrow|burrow
widening|widening
shaggy|shaggy
antiquated|antiquated
chastise|chastise
stockpile|stockpile
quarrel|quarrel
seniority|seniority
wheeze|wheeze
integrative|integrative
polluter|polluter
balm|balm
flattering|flattering
flit|flit
flooring|flooring
brawl|brawl
dung|dung
oar|oar
centrally|centrally
virulent|virulent
switching|switching
readership|readership
penthouse|penthouse
punishing|punishing
swat|swat
sear|sear
nomad|nomad
revitalization|revitalization
bog|bog
optic|optic
caseload|caseload
resourceful|resourceful
format|format
barbarian|barbarian
karate|karate
eyesight|eyesight
noose|noose
newsstand|newsstand
sap|sap
insertion|insertion
ranked|ranked
rowdy|rowdy
vocalist|vocalist
deformed|deformed
outside|outside
awry|awry
sandwich|sandwich
belie|belie
coexistence|coexistence
dam|dam
hoard|hoard
affluence|affluence
evergreen|evergreen
minnow|minnow
anyplace|anyplace
methodical|methodical
tycoon|tycoon
agility|agility
botanist|botanist
rigidity|rigidity
throb|throb
smash|smash
adaptable|adaptable
consequent|consequent
caseworker|caseworker
deft|deft
multicolored|multicolored
reprimand|reprimand
dunk|dunk
marketable|marketable
contemplative|contemplative
jab|jab
industrialist|industrialist
roundup|roundup
leaky|leaky
macroeconomic|macroeconomic
subtest|subtest
severance|severance
stallion|stallion
aspen|aspen
exhausting|exhausting
ebb|ebb
bayonet|bayonet
respectability|respectability
unremarkable|unremarkable
wallow|wallow
reflected|reflected
interchangeable|interchangeable
potted|potted
exasperation|exasperation
gaudy|gaudy
hemp|hemp
secrete|secrete
enriched|enriched
flunk|flunk
maniac|maniac
wrest|wrest
whittle|whittle
lovemaking|lovemaking
recitation|recitation
practiced|practiced
runaway|runaway
crippled|crippled
piston|piston
cleat|cleat
aggressiveness|aggressiveness
unzip|unzip
scotch|scotch
effortless|effortless
clique|clique
serial|serial
lukewarm|lukewarm
wiper|wiper
underclass|underclass
prey|prey
heinous|heinous
poacher|poacher
tome|tome
entomologist|entomologist
sterling|sterling
twine|twine
potion|potion
lucid|lucid
consumerism|consumerism
enticing|enticing
tortured|tortured
enliven|enliven
arch|arch
scum|scum
disillusion|disillusion
acupuncture|acupuncture
whomever|whomever
slimy|slimy
starship|starship
intolerant|intolerant
neoclassical|neoclassical
deformity|deformity
suction|suction
gurney|gurney
pursuant|pursuant
clergyman|clergyman
grounding|grounding
forwards|forwards
envious|envious
drunk|drunk
pomegranate|pomegranate
swish|swish
resounding|resounding
upstart|upstart
detectable|detectable
vigilante|vigilante
precocious|precocious
sleazy|sleazy
bottleneck|bottleneck
cowardly|cowardly
retiring|retiring
garland|garland
unsettling|unsettling
toenail|toenail
celebratory|celebratory
rugby|rugby
compatriot|compatriot
array|array
proffer|proffer
commons|commons
empowering|empowering
terrier|terrier
aviator|aviator
daily|daily
solicitation|solicitation
drone|drone
epidemiologist|epidemiologist
conspirator|conspirator
quandary|quandary
acoustic|acoustic
hoot|hoot
twitch|twitch
sickle|sickle
slut|slut
tendril|tendril
concierge|concierge
encryption|encryption
organic|organic
speckled|speckled
flush|flush
congenital|congenital
jiggle|jiggle
hairline|hairline
attitudinal|attitudinal
amenable|amenable
widower|widower
cheesy|cheesy
darling|darling
chairwoman|chairwoman
mournful|mournful
ire|ire
saber|saber
sabbatical|sabbatical
revulsion|revulsion
issuing|issuing
swirling|swirling
structurally|structurally
pretzel|pretzel
arbitrarily|arbitrarily
annihilation|annihilation
poise|poise
drool|drool
falcon|falcon
giving|giving
dill|dill
jumpsuit|jumpsuit
eave|eave
masquerade|masquerade
shambles|shambles
alleyway|alleyway
silt|silt
tumble|tumble
bile|bile
relapse|relapse
Panamanian|Panamanian
biz|biz
baboon|baboon
nave|nave
char|char
psychoanalytic|psychoanalytic
concise|concise
eccentricity|eccentricity
deceptively|deceptively
plunder|plunder
indigent|indigent
masquerade|masquerade
plod|plod
downpour|downpour
misplaced|misplaced
smartly|smartly
lexicon|lexicon
disillusionment|disillusionment
feathered|feathered
lumber|lumber
counterinsurgency|counterinsurgency
hitherto|hitherto
jogger|jogger
tanned|tanned
layman|layman
assent|assent
unanticipated|unanticipated
censor|censor
breakfast|breakfast
mythological|mythological
multiracial|multiracial
expiration|expiration
unintentionally|unintentionally
midpoint|midpoint
slaughterhouse|slaughterhouse
banjo|banjo
eucalyptus|eucalyptus
astrophysicist|astrophysicist
winter|winter
touchy|touchy
heretofore|heretofore
graphically|graphically
harbinger|harbinger
unmistakably|unmistakably
starkly|starkly
banal|banal
uneasiness|uneasiness
motherfucker|motherfucker
even|even
cheeseburger|cheeseburger
dissimilar|dissimilar
accession|accession
airspace|airspace
squeak|squeak
interfaith|interfaith
woolly|woolly
elucidate|elucidate
upsetting|upsetting
schoolyard|schoolyard
macro|macro
confectioner|confectioner
universality|universality
beeper|beeper
trying|trying
galvanized|galvanized
wimp|wimp
inflection|inflection
maneuvering|maneuvering
snippet|snippet
frenetic|frenetic
hallowed|hallowed
interface|interface
milling|milling
reload|reload
antecedent|antecedent
downgrade|downgrade
stumbling|stumbling
popularly|popularly
figuratively|figuratively
applicability|applicability
slugger|slugger
grandpa|grandpa
mackerel|mackerel
forgery|forgery
swipe|swipe
picky|picky
scrimmage|scrimmage
trove|trove
peculiarity|peculiarity
liquidate|liquidate
whiz|whiz
monsoon|monsoon
mammoth|mammoth
bottomless|bottomless
lick|lick
crossfire|crossfire
scouting|scouting
aft|aft
skitter|skitter
tearful|tearful
inverse|inverse
quartz|quartz
released|released
downstream|downstream
woodpecker|woodpecker
intergovernmental|intergovernmental
televise|televise
cuff|cuff
truckload|truckload
sand|sand
eloquence|eloquence
geyser|geyser
vegetative|vegetative
amber|amber
intifada|intifada
underdeveloped|underdeveloped
grazing|grazing
glut|glut
sheaf|sheaf
boob|boob
disengagement|disengagement
headmaster|headmaster
earmark|earmark
mercifully|mercifully
micron|micron
flowered|flowered
posse|posse
lackluster|lackluster
silhouette|silhouette
legume|legume
fibrous|fibrous
succulent|succulent
resettle|resettle
scented|scented
moat|moat
longitude|longitude
depositor|depositor
classically|classically
lefty|lefty
pesky|pesky
progeny|progeny
interminable|interminable
communique|communique
meth|meth
bouncing|bouncing
merciless|merciless
deregulate|deregulate
pita|pita
rote|rote
collapsing|collapsing
retake|retake
substandard|substandard
khakis|khakis
venison|venison
institutionalization|institutionalization
feta|feta
banter|banter
impel|impel
malt|malt
snowshoe|snowshoe
anathema|anathema
prohibited|prohibited
halibut|halibut
coy|coy
garish|garish
drowsy|drowsy
absolve|absolve
uterine|uterine
gawk|gawk
gallant|gallant
snowboard|snowboard
pursuer|pursuer
dynamism|dynamism
actuator|actuator
checkered|checkered
shuffle|shuffle
inaccuracy|inaccuracy
ancillary|ancillary
spraying|spraying
reverend|reverend
firecracker|firecracker
surly|surly
gregarious|gregarious
theorem|theorem
slain|slain
vilify|vilify
fortitude|fortitude
distal|distal
counterfeit|counterfeit
empathetic|empathetic
fruity|fruity
corset|corset
memorialize|memorialize
readable|readable
mystic|mystic
untenable|untenable
congregational|congregational
exhortation|exhortation
adaptability|adaptability
capricious|capricious
sameness|sameness
peacemaker|peacemaker
stampede|stampede
brainwash|brainwash
unproductive|unproductive
miscalculation|miscalculation
incendiary|incendiary
hearsay|hearsay
luminary|luminary
reassign|reassign
ineffectual|ineffectual
exclusionary|exclusionary
solicitor|solicitor
monopolize|monopolize
pancreas|pancreas
racketeering|racketeering
fell|fell
offshoot|offshoot
matched|matched
insensitivity|insensitivity
lance|lance
chieftain|chieftain
enchant|enchant
snack|snack
steelhead|steelhead
regrettable|regrettable
microchip|microchip
grand|grand
orb|orb
Aryan|Aryan
crow|crow
snipe|snipe
finisher|finisher
reclusive|reclusive
shove|shove
conclusively|conclusively
hideaway|hideaway
transformer|transformer
landlady|landlady
blemish|blemish
multimillionaire|multimillionaire
implode|implode
acquiescence|acquiescence
indecision|indecision
reinvigorate|reinvigorate
spending|spending
esteemed|esteemed
cantaloupe|cantaloupe
uninformed|uninformed
demented|demented
cannibal|cannibal
unchanging|unchanging
screener|screener
macro|macro
dotted|dotted
distinctively|distinctively
inexorable|inexorable
breech|breech
homily|homily
habitually|habitually
chipped|chipped
outreach|outreach
counterbalance|counterbalance
forerunner|forerunner
underfunded|underfunded
foolishly|foolishly
prepaid|prepaid
lynch|lynch
cauldron|cauldron
Yiddish|Yiddish
riser|riser
swig|swig
chairmanship|chairmanship
belated|belated
drizzle|drizzle
radiologist|radiologist
sac|sac
intoxication|intoxication
reprehensible|reprehensible
connectedness|connectedness
magenta|magenta
mannerism|mannerism
hysterically|hysterically
repaint|repaint
squabble|squabble
heartless|heartless
excision|excision
karma|karma
decadence|decadence
impurity|impurity
summation|summation
lithe|lithe
filet|filet
torch|torch
rheumatoid|rheumatoid
humbling|humbling
tribesman|tribesman
heh|heh
gumbo|gumbo
meaningfully|meaningfully
chisel|chisel
shanty|shanty
supplementation|supplementation
llama|llama
seamstress|seamstress
peep|peep
windswept|windswept
captivating|captivating
radon|radon
newsman|newsman
preoperative|preoperative
erstwhile|erstwhile
untimely|untimely
snowman|snowman
tail|tail
lewd|lewd
puncture|puncture
goatee|goatee
Sioux|Sioux
devolve|devolve
tightness|tightness
delirious|delirious
mutilated|mutilated
vengeful|vengeful
collie|collie
fake|fake
playback|playback
unharmed|unharmed
compendium|compendium
clang|clang
nay|nay
countenance|countenance
muscle|muscle
foursome|foursome
heartbroken|heartbroken
abut|abut
abrasion|abrasion
payable|payable
staccato|staccato
swatch|swatch
tested|tested
scarred|scarred
vastness|vastness
dictatorial|dictatorial
fell|fell
renovated|renovated
cobweb|cobweb
approvingly|approvingly
parlay|parlay
senatorial|senatorial
dilate|dilate
soapy|soapy
groggy|groggy
impressively|impressively
negation|negation
earphone|earphone
inscrutable|inscrutable
asterisk|asterisk
polarity|polarity
wrack|wrack
splurge|splurge
sardonic|sardonic
episodic|episodic
censure|censure
deodorant|deodorant
drunkenness|drunkenness
mammalian|mammalian
vitally|vitally
turpentine|turpentine
lark|lark
anachronistic|anachronistic
ostrich|ostrich
cooperating|cooperating
headwaters|headwaters
unknowingly|unknowingly
diocesan|diocesan
degenerative|degenerative
overzealous|overzealous
birthright|birthright
regressive|regressive
dusky|dusky
unholy|unholy
advisable|advisable
reveler|reveler
clockwork|clockwork
elbow|elbow
acrid|acrid
latency|latency
renege|renege
curd|curd
contagion|contagion
jetty|jetty
burlap|burlap
muffler|muffler
leech|leech
intermission|intermission
neophyte|neophyte
overjoyed|overjoyed
wham|wham
cataclysmic|cataclysmic
hog|hog
isolationist|isolationist
gory|gory
deciding|deciding
toothless|toothless
glower|glower
lightbulb|lightbulb
rec|rec
bloodied|bloodied
talking|talking
welt|welt
tramp|tramp
salami|salami
corkscrew|corkscrew
yardage|yardage
industrious|industrious
songwriting|songwriting
unplugged|unplugged
hereby|hereby
nonsignificant|nonsignificant
realtor|realtor
glimmer|glimmer
mammography|mammography
fawn|fawn
iguana|iguana
descriptor|descriptor
bot|bot
uproot|uproot
precipice|precipice
still|still
synopsis|synopsis
poncho|poncho
season|season
panicky|panicky
glassware|glassware
fluttering|fluttering
muddle|muddle
docile|docile
peroxide|peroxide
echoing|echoing
regalia|regalia
bipartisanship|bipartisanship
fanaticism|fanaticism
uninvited|uninvited
lunch|lunch
bro|bro
prejudice|prejudice
escaping|escaping
manatee|manatee
sit|sit
ugh|ugh
erroneously|erroneously
Newtonian|Newtonian
pewter|pewter
intensified|intensified
enlistment|enlistment
jus|jus
riverbed|riverbed
trusty|trusty
showcase|showcase
nonmember|nonmember
swab|swab
handily|handily
exclusivity|exclusivity
postdoctoral|postdoctoral
frat|frat
estrangement|estrangement
banister|banister
derivative|derivative
overcome|overcome
patter|patter
unlicensed|unlicensed
laziness|laziness
conspiratorial|conspiratorial
stupidly|stupidly
blunder|blunder
antibacterial|antibacterial
acrobat|acrobat
fedora|fedora
incapacitate|incapacitate
pansy|pansy
carnal|carnal
horned|horned
weatherman|weatherman
carbonate|carbonate
weedy|weedy
canny|canny
retreating|retreating
mute|mute
degraded|degraded
toleration|toleration
wherewithal|wherewithal
commuting|commuting
sentinel|sentinel
covariate|covariate
storehouse|storehouse
phenomenological|phenomenological
shading|shading
endoscopic|endoscopic
airlift|airlift
yum|yum
confetti|confetti
unconvinced|unconvinced
hassle|hassle
dividing|dividing
direct|direct
customarily|customarily
canvas|canvas
repairman|repairman
mestizo|mestizo
toil|toil
convergent|convergent
ceaseless|ceaseless
extort|extort
togetherness|togetherness
stopped|stopped
feline|feline
unfolding|unfolding
overstuffed|overstuffed
dorsal|dorsal
commercialism|commercialism
prosocial|prosocial
secularist|secularist
shadowed|shadowed
gaggle|gaggle
rationalism|rationalism
mangled|mangled
infallible|infallible
redemptive|redemptive
vane|vane
silica|silica
middleman|middleman
conscription|conscription
imperceptible|imperceptible
intercultural|intercultural
goddam|goddam
interviewing|interviewing
naught|naught
deflation|deflation
revived|revived
hm|hm
rangeland|rangeland
debrief|debrief
imperceptibly|imperceptibly
tassel|tassel
tarpon|tarpon
foretell|foretell
scone|scone
suffocating|suffocating
monotone|monotone
solidity|solidity
cream|cream
antihistamine|antihistamine
whet|whet
delirium|delirium
negotiable|negotiable
disorientation|disorientation
rejuvenated|rejuvenated
caddy|caddy
disenfranchise|disenfranchise
forklift|forklift
constipation|constipation
lollipop|lollipop
refurbished|refurbished
plump|plump
lustrous|lustrous
shrubbery|shrubbery
truism|truism
mil|mil
blond|blond
inalienable|inalienable
deflection|deflection
overhanging|overhanging
weekly|weekly
Aristotelian|Aristotelian
ophthalmologist|ophthalmologist
bailiff|bailiff
dissension|dissension
personage|personage
mitigating|mitigating
lubricate|lubricate
afire|afire
yon|yon
hickory|hickory
sportscaster|sportscaster
paternalistic|paternalistic
underpainting|underpainting
SOS|SOS
slob|slob
inversely|inversely
volition|volition
egret|egret
wastebasket|wastebasket
waistline|waistline
hater|hater
diabolical|diabolical
unencumbered|unencumbered
dispensation|dispensation
beget|beget
damp|damp
coldness|coldness
unaided|unaided
minion|minion
ruffled|ruffled
needed|needed
starring|starring
sulfide|sulfide
jazzy|jazzy
psychoanalyst|psychoanalyst
shrunken|shrunken
opportunist|opportunist
reconsideration|reconsideration
upstage|upstage
stagecoach|stagecoach
powwow|powwow
comedic|comedic
drudgery|drudgery
sycamore|sycamore
monstrosity|monstrosity
empathic|empathic
foreword|foreword
presage|presage
irradiation|irradiation
stepdaughter|stepdaughter
assuredly|assuredly
carpentry|carpentry
lotus|lotus
dipping|dipping
astrophysics|astrophysics
interloper|interloper
manhole|manhole
chalk|chalk
fastidious|fastidious
rut|rut
scat|scat
earlobe|earlobe
return|return
watercress|watercress
snatch|snatch
swearing|swearing
heist|heist
encyclopedic|encyclopedic
slayer|slayer
upstate|upstate
divinely|divinely
trombone|trombone
taping|taping
perpetuation|perpetuation
crowbar|crowbar
impressionable|impressionable
burp|burp
cognitively|cognitively
mooring|mooring
inky|inky
teal|teal
androgynous|androgynous
hallucinate|hallucinate
fitted|fitted
underprivileged|underprivileged
menopausal|menopausal
orbiting|orbiting
encyclical|encyclical
constituted|constituted
rated|rated
papacy|papacy
irreparable|irreparable
bib|bib
tuba|tuba
whoo|whoo
milking|milking
bicentennial|bicentennial
arrhythmia|arrhythmia
undivided|undivided
stork|stork
strobe|strobe
employed|employed
manger|manger
biennial|biennial
obviate|obviate
ironing|ironing
mullah|mullah
tease|tease
marbled|marbled
originator|originator
hairpin|hairpin
emir|emir
sportswear|sportswear
doggedly|doggedly
clap|clap
perishable|perishable
curt|curt
withholding|withholding
fiduciary|fiduciary
gesso|gesso
methyl|methyl
irrigated|irrigated
obelisk|obelisk
consecrate|consecrate
handyman|handyman
Yoruba|Yoruba
gentry|gentry
overpass|overpass
panoply|panoply
misinterpretation|misinterpretation
uncut|uncut
shrinkage|shrinkage
transporter|transporter
cookware|cookware
spawn|spawn
hearten|hearten
trundle|trundle
unconscious|unconscious
persimmon|persimmon
Sikh|Sikh
fertilized|fertilized
Jamaican|Jamaican
incrementally|incrementally
boxwood|boxwood
moralistic|moralistic
wariness|wariness
compiler|compiler
wordlessly|wordlessly
ebullient|ebullient
leased|leased
telecommuting|telecommuting
absorbed|absorbed
fag|fag
swathe|swathe
purgatory|purgatory
firm|firm
wacko|wacko
theocracy|theocracy
raspy|raspy
resection|resection
showman|showman
binocular|binocular
brownish|brownish
girdle|girdle
detonator|detonator
licorice|licorice
synchronous|synchronous
backcourt|backcourt
indecisive|indecisive
spiced|spiced
reprise|reprise
rivulet|rivulet
avidly|avidly
fog|fog
reflux|reflux
conquistador|conquistador
seaport|seaport
soberly|soberly
po|po
beseech|beseech
nub|nub
trustworthiness|trustworthiness
crawler|crawler
filibuster|filibuster
snooze|snooze
colonized|colonized
lethargy|lethargy
foreplay|foreplay
revolting|revolting
storyline|storyline
tedium|tedium
protestation|protestation
dejected|dejected
exploding|exploding
grasping|grasping
legalized|legalized
headland|headland
breath|breath
yielding|yielding
eugenics|eugenics
applesauce|applesauce
dashed|dashed
judging|judging
straightaway|straightaway
suppressed|suppressed
activated|activated
unopposed|unopposed
dismissively|dismissively
genealogical|genealogical
undertaker|undertaker
crosshair|crosshair
insubstantial|insubstantial
splashy|splashy
underling|underling
slippage|slippage
regimental|regimental
weirdly|weirdly
Mennonite|Mennonite
glazing|glazing
blight|blight
bloodline|bloodline
ornamentation|ornamentation
immensity|immensity
fatalism|fatalism
retractable|retractable
card|card
pi|pi
randomness|randomness
constancy|constancy
tender|tender
mulch|mulch
bluster|bluster
shaken|shaken
exorcism|exorcism
toy|toy
babble|babble
amended|amended
spacesuit|spacesuit
reinstatement|reinstatement
counterfeit|counterfeit
truncated|truncated
acclimate|acclimate
cordon|cordon
frighteningly|frighteningly
mollify|mollify
distillation|distillation
supposing|supposing
agitator|agitator
vicariously|vicariously
trinitarian|trinitarian
medicate|medicate
cloned|cloned
motorsport|motorsport
sinusitis|sinusitis
pinstripe|pinstripe
longingly|longingly
var|var
triangulation|triangulation
teaser|teaser
Napoleonic|Napoleonic
scorching|scorching
distracting|distracting
proportionality|proportionality
afterward|afterward
producing|producing
ting|ting
molar|molar
impartiality|impartiality
verve|verve
capillary|capillary
journeyman|journeyman
buyback|buyback
satirize|satirize
multiplex|multiplex
sparring|sparring
geophysical|geophysical
ultrasonic|ultrasonic
bluebird|bluebird
tines|tines
frostbite|frostbite
flagpole|flagpole
dramatist|dramatist
manganese|manganese
stressed|stressed
refiner|refiner
fjord|fjord
blurring|blurring
unclaimed|unclaimed
doggy|doggy
void|void
anthropogenic|anthropogenic
brusque|brusque
sisterhood|sisterhood
accommodating|accommodating
soap|soap
slight|slight
epilogue|epilogue
reverently|reverently
retest|retest
upwardly|upwardly
kinsman|kinsman
pretender|pretender
deadlock|deadlock
subjectively|subjectively
dissociate|dissociate
peephole|peephole
infatuated|infatuated
tenfold|tenfold
glittery|glittery
opened|opened
armistice|armistice
brassy|brassy
chronologically|chronologically
tympanic|tympanic
statehouse|statehouse
ribbed|ribbed
noncommercial|noncommercial
Estonian|Estonian
rue|rue
Eurocentric|Eurocentric
hallelujah|hallelujah
cube|cube
redeploy|redeploy
couplet|couplet
indebtedness|indebtedness
womanly|womanly
apportion|apportion
requested|requested
doggie|doggie
tabernacle|tabernacle
brazenly|brazenly
lynx|lynx
wonderland|wonderland
refract|refract
splotch|splotch
cabinetry|cabinetry
afterglow|afterglow
conjoin|conjoin
photogenic|photogenic
corrective|corrective
smugly|smugly
prickle|prickle
entrap|entrap
strangulation|strangulation
slew|slew
minuteman|minuteman
catalyze|catalyze
transferred|transferred
bespeak|bespeak
flatness|flatness
taxicab|taxicab
carotene|carotene
swindle|swindle
snowmaking|snowmaking
congeal|congeal
acrimony|acrimony
disciplinarian|disciplinarian
serenade|serenade
segregationist|segregationist
artisanal|artisanal
snide|snide
protectorate|protectorate
cabby|cabby
basilica|basilica
manure|manure
seeking|seeking
byline|byline
geezer|geezer
shrewdly|shrewdly
prefabricated|prefabricated
debase|debase
reopening|reopening
junket|junket
segmentation|segmentation
vixen|vixen
palliative|palliative
unacknowledged|unacknowledged
deposed|deposed
hock|hock
whoop|whoop
morn|morn
torrid|torrid
bending|bending
disdainful|disdainful
exhalation|exhalation
punt|punt
Catalan|Catalan
expansionist|expansionist
phoneme|phoneme
hackle|hackle
Neolithic|Neolithic
unbearably|unbearably
omelette|omelette
microcomputer|microcomputer
clogged|clogged
humorless|humorless
sauerkraut|sauerkraut
yellowing|yellowing
fail|fail
redevelop|redevelop
podcast|podcast
beachhead|beachhead
contoured|contoured
unhelpful|unhelpful
kingship|kingship
telemetry|telemetry
osprey|osprey
scandalize|scandalize
principality|principality
Nepalese|Nepalese
Athenian|Athenian
pontiff|pontiff
judo|judo
fortnight|fortnight
helix|helix
endocrine|endocrine
minaret|minaret
Keynesian|Keynesian
rook|rook
grail|grail
conductivity|conductivity
allspice|allspice
laid|laid
reptilian|reptilian
doer|doer
fecundity|fecundity
jarring|jarring
middling|middling
florid|florid
prompting|prompting
raffia|raffia
ornithologist|ornithologist
bloodbath|bloodbath
torpedo|torpedo
sternum|sternum
autumnal|autumnal
paramilitary|paramilitary
directorial|directorial
segment|segment
blackbird|blackbird
lambast|lambast
copper|copper
segmented|segmented
enticement|enticement
behaviorist|behaviorist
reactivity|reactivity
Dutchman|Dutchman
asymptomatic|asymptomatic
cosmonaut|cosmonaut
jumble|jumble
reinforcer|reinforcer
barbarian|barbarian
blasphemous|blasphemous
revelry|revelry
lozenge|lozenge
toot|toot
detoxification|detoxification
stolid|stolid
annotation|annotation
forked|forked
fiddler|fiddler
viper|viper
plover|plover
jumbled|jumbled
focuser|focuser
crackpot|crackpot
Sistine|Sistine
ravaged|ravaged
jamb|jamb
dusting|dusting
indomitable|indomitable
marmalade|marmalade
prowl|prowl
chiseled|chiseled
hunger|hunger
occidental|occidental
excavator|excavator
practicable|practicable
disaffection|disaffection
fatherland|fatherland
enrollee|enrollee
chattering|chattering
fatherless|fatherless
grotesquely|grotesquely
irrationality|irrationality
hitchhiker|hitchhiker
analogical|analogical
rationalist|rationalist
sparkly|sparkly
cassava|cassava
atherosclerosis|atherosclerosis
mounting|mounting
stepparent|stepparent
unrequited|unrequited
rerun|rerun
headrest|headrest
guardrail|guardrail
secretariat|secretariat
thrusting|thrusting
cursive|cursive
induced|induced
beadwork|beadwork
hypothetically|hypothetically
mandolin|mandolin
stimulator|stimulator
torturous|torturous
uncommitted|uncommitted
houseplant|houseplant
icebox|icebox
marionette|marionette
femoral|femoral
knotty|knotty
apprise|apprise
separateness|separateness
radiology|radiology
disjunction|disjunction
votive|votive
germplasm|germplasm
scruple|scruple
woodsman|woodsman
syrupy|syrupy
faint|faint
matrimony|matrimony
swallowed|swallowed
portobello|portobello
agnostic|agnostic
appellation|appellation
joining|joining
wretch|wretch
socialized|socialized
valence|valence
prophylactic|prophylactic
deign|deign
leaked|leaked
inhabited|inhabited
waterline|waterline
pontoon|pontoon
post|post
shimmy|shimmy
siting|siting
purchased|purchased
racquetball|racquetball
paisley|paisley
collectivist|collectivist
concealer|concealer
midriff|midriff
famished|famished
unbleached|unbleached
some|some
isthmus|isthmus
Moorish|Moorish
physiologic|physiologic
eventful|eventful
dredge|dredge
cheating|cheating
riverfront|riverfront
traverse|traverse
paleolithic|paleolithic
supervised|supervised
apotheosis|apotheosis
fourfold|fourfold
carbine|carbine
rose|rose
guessing|guessing
backhand|backhand
specious|specious
squamous|squamous
workspace|workspace
pith|pith
Slav|Slav
panty|panty
magnanimous|magnanimous
millionth|millionth
armory|armory
pullback|pullback
cabinetmaker|cabinetmaker
viceroy|viceroy
rollicking|rollicking
heathen|heathen
hissing|hissing
retrospectively|retrospectively
panhandler|panhandler
unsay|unsay
thematically|thematically
gran|gran
disposed|disposed
voyager|voyager
greyhound|greyhound
readability|readability
ventilate|ventilate
depreciate|depreciate
uptick|uptick
Socratic|Socratic
cerulean|cerulean
oversimplification|oversimplification
impassively|impassively
undertow|undertow
premeditated|premeditated
fallback|fallback
burgundy|burgundy
chipmunk|chipmunk
kitchenette|kitchenette
dynamically|dynamically
dyadic|dyadic
uncannily|uncannily
dole|dole
nondenominational|nondenominational
deviance|deviance
cloister|cloister
hyperventilate|hyperventilate
voiceless|voiceless
obtuse|obtuse
automaton|automaton
imbibe|imbibe
anteroom|anteroom
corroboration|corroboration
undeserved|undeserved
incestuous|incestuous
guile|guile
knobby|knobby
disbursement|disbursement
droopy|droopy
emitter|emitter
seepage|seepage
divan|divan
pylorus|pylorus
civilizing|civilizing
chump|chump
amalgamation|amalgamation
classicism|classicism
incapacity|incapacity
generically|generically
endgame|endgame
harangue|harangue
impolite|impolite
deserved|deserved
rucksack|rucksack
sartorial|sartorial
remiss|remiss
gestalt|gestalt
filmmaking|filmmaking
profane|profane
cryogenic|cryogenic
waif|waif
uncork|uncork
casein|casein
bloodstain|bloodstain
boathouse|boathouse
ungodly|ungodly
amplified|amplified
streetwise|streetwise
uninhabitable|uninhabitable
inequitable|inequitable
tomatillo|tomatillo
prepackaged|prepackaged
mend|mend
jackhammer|jackhammer
scraggly|scraggly
armature|armature
quartile|quartile
interconnectedness|interconnectedness
frizzy|frizzy
softwood|softwood
possessor|possessor
matchstick|matchstick
stunner|stunner
mongrel|mongrel
convolute|convolute
egocentric|egocentric
irascible|irascible
recoverable|recoverable
suffocation|suffocation
neuromuscular|neuromuscular
blase|blase
reachable|reachable
realpolitik|realpolitik
tangent|tangent
poly|poly
poof|poof
section|section
toggle|toggle
gravelly|gravelly
mamma|mamma
sadism|sadism
whoops|whoops
stoicism|stoicism
tapioca|tapioca
behaviorally|behaviorally
unadulterated|unadulterated
jester|jester
forceps|forceps
zeppelin|zeppelin
constitutionalism|constitutionalism
telecast|telecast
provocatively|provocatively
hillock|hillock
tincture|tincture
loaf|loaf
groomed|groomed
mignon|mignon
timelessness|timelessness
radicchio|radicchio
ritzy|ritzy
lycopene|lycopene
Orwellian|Orwellian
Americanist|Americanist
dockside|dockside
inveterate|inveterate
refraction|refraction
midshipman|midshipman
undermining|undermining
thence|thence
willowy|willowy
snoop|snoop
quesadilla|quesadilla
comely|comely
unfashionable|unfashionable
auteur|auteur
unbounded|unbounded
expressiveness|expressiveness
crystallized|crystallized
symptomatology|symptomatology
prissy|prissy
sleaze|sleaze
inlay|inlay
abstention|abstention
sombrero|sombrero
predicate|predicate
natal|natal
tardiness|tardiness
traumatized|traumatized
tailspin|tailspin
jovian|jovian
dandruff|dandruff
insomniac|insomniac
phosphorous|phosphorous
wading|wading
monorail|monorail
blurb|blurb
intoxicated|intoxicated
carload|carload
boatload|boatload
windscreen|windscreen
gunfight|gunfight
coffeemaker|coffeemaker
tulle|tulle
clematis|clematis
tenaciously|tenaciously
lorry|lorry
sufficiency|sufficiency
comparability|comparability
tableware|tableware
tonsillectomy|tonsillectomy
inimitable|inimitable
hammering|hammering
credibly|credibly
individuation|individuation
prospect|prospect
nonrenewable|nonrenewable
riff|riff
condensate|condensate
pitifully|pitifully
logbook|logbook
homebuyer|homebuyer
delicatessen|delicatessen
disgrace|disgrace
revocation|revocation
treehouse|treehouse
manna|manna
macrophage|macrophage
maxillary|maxillary
naturalness|naturalness
due|due
paraplegic|paraplegic
save|save
muskie|muskie
wonk|wonk
validated|validated
turnabout|turnabout
rapturous|rapturous
mortician|mortician
humming|humming
lube|lube
downer|downer
decoding|decoding
fishbowl|fishbowl
mishmash|mishmash
foist|foist
quoted|quoted
Kashmiri|Kashmiri
busty|busty
percussionist|percussionist
dalliance|dalliance
blacklist|blacklist
moisturize|moisturize
protrusion|protrusion
brawn|brawn
doorjamb|doorjamb
rogue|rogue
perp|perp
tangential|tangential
smoothie|smoothie
thirtieth|thirtieth
excluded|excluded
knowable|knowable
wasabi|wasabi
bather|bather
undiminished|undiminished
diaphanous|diaphanous
expired|expired
attenuation|attenuation
gusty|gusty
convocation|convocation
taupe|taupe
speedily|speedily
kitty|kitty
tactically|tactically
homeopathy|homeopathy
incise|incise
grilling|grilling
cloistered|cloistered
pliant|pliant
weakling|weakling
wisecrack|wisecrack
chanterelle|chanterelle
grumble|grumble
fenced|fenced
chaff|chaff
hanky|hanky
chanting|chanting
diphtheria|diphtheria
unglamorous|unglamorous
irrationally|irrationally
chamois|chamois
modeler|modeler
overtax|overtax
offended|offended
ensign|ensign
reaper|reaper
criminology|criminology
cinematography|cinematography
curvilinear|curvilinear
typeface|typeface
lumberjack|lumberjack
semiotics|semiotics
smeared|smeared
cos|cos
talus|talus
argon|argon
towel|towel
downwind|downwind
hygienist|hygienist
podiatrist|podiatrist
vociferously|vociferously
footbridge|footbridge
sashay|sashay
beltway|beltway
Rolodex|Rolodex
undulate|undulate
hawker|hawker
exhaustively|exhaustively
hillbilly|hillbilly
councilor|councilor
lawfully|lawfully
showpiece|showpiece
thwarted|thwarted
brawl|brawl
Hopi|Hopi
earthwork|earthwork
exotic|exotic
desirous|desirous
teachable|teachable
epigraph|epigraph
authoritatively|authoritatively
parabolic|parabolic
incitement|incitement
underemployed|underemployed
wordplay|wordplay
incoherence|incoherence
filmy|filmy
hauntingly|hauntingly
lurking|lurking
therapeutics|therapeutics
somersault|somersault
hardening|hardening
sarcoma|sarcoma
midline|midline
crossbar|crossbar
beck|beck
cay|cay
marksmanship|marksmanship
peripatetic|peripatetic
forger|forger
shakeout|shakeout
teary|teary
hobnob|hobnob
goldsmith|goldsmith
whipping|whipping
bothered|bothered
silenced|silenced
lingua|lingua
adventuresome|adventuresome
pinhole|pinhole
greenback|greenback
girlie|girlie
cantilever|cantilever
eyeshadow|eyeshadow
gaiety|gaiety
showstopper|showstopper
reseller|reseller
virulence|virulence
schoolbook|schoolbook
pleading|pleading
occult|occult
preliminary|preliminary
rosebush|rosebush
subservience|subservience
intertextual|intertextual
thievery|thievery
mangy|mangy
repetitious|repetitious
peeved|peeved
composed|composed
spidery|spidery
maladjustment|maladjustment
protean|protean
temerity|temerity
bobsled|bobsled
Scots|Scots
drifting|drifting
telegraph|telegraph
unconstrained|unconstrained
dint|dint
snowbank|snowbank
denude|denude
stupidest|stupidest
drunkenly|drunkenly
fore|fore
screamer|screamer
pillbox|pillbox
musicality|musicality
silt|silt
barrister|barrister
rooming|rooming
frazzle|frazzle
imp|imp
windward|windward
sodomize|sodomize
hepatic|hepatic
ballclub|ballclub
teasingly|teasingly
tantalizingly|tantalizingly
fascia|fascia
relativist|relativist
overhand|overhand
abortionist|abortionist
sketching|sketching
statuesque|statuesque
regrowth|regrowth
lilt|lilt
beheading|beheading
royally|royally
unionist|unionist
philology|philology
accusingly|accusingly
waltz|waltz
wiz|wiz
nominated|nominated
avionics|avionics
warmed|warmed
enunciation|enunciation
slowing|slowing
dragnet|dragnet
globalism|globalism
microbiological|microbiological
promulgation|promulgation
turbocharged|turbocharged
sump|sump
spar|spar
stripe|stripe
intravenously|intravenously
whiplash|whiplash
thoroughgoing|thoroughgoing
Bengal|Bengal
debilitate|debilitate
showtime|showtime
collectivism|collectivism
crusted|crusted
multiculturalist|multiculturalist
irretrievably|irretrievably
shareware|shareware
cantina|cantina
bloodletting|bloodletting
convivial|convivial
wellhead|wellhead
unassisted|unassisted
thereabouts|thereabouts
spiffy|spiffy
Laotian|Laotian
unexploded|unexploded
tamarind|tamarind
hedonistic|hedonistic
Slovak|Slovak
cardiopulmonary|cardiopulmonary
powerboat|powerboat
lupine|lupine
patched|patched
canard|canard
handicapper|handicapper
pulling|pulling
oo|oo
henna|henna
scepter|scepter
anchoring|anchoring
chickadee|chickadee
hitman|hitman
plunger|plunger
slicer|slicer
patrilineal|patrilineal
fecund|fecund
offhand|offhand
savannah|savannah
vapid|vapid
archduke|archduke
impoverish|impoverish
linearity|linearity
transsexual|transsexual
misfire|misfire
undervalued|undervalued
arbitrage|arbitrage
gentile|gentile
vomiting|vomiting
pseudo|pseudo
seahorse|seahorse
disrepute|disrepute
pilothouse|pilothouse
sterilized|sterilized
tabby|tabby
spitting|spitting
imperialist|imperialist
expansionism|expansionism
musicologist|musicologist
agonizingly|agonizingly
usability|usability
fieldstone|fieldstone
clandestinely|clandestinely
geophysicist|geophysicist
ravish|ravish
orgasmic|orgasmic
menstruate|menstruate
pillory|pillory
gendarme|gendarme
doff|doff
renegotiation|renegotiation
enlightening|enlightening
prowler|prowler
harangue|harangue
metallurgy|metallurgy
sensorineural|sensorineural
reversed|reversed
chipping|chipping
hilariously|hilariously
tousled|tousled
juke|juke
blank|blank
balsa|balsa
uninjured|uninjured
unorganized|unorganized
bordello|bordello
gastroenterologist|gastroenterologist
proffered|proffered
huddled|huddled
phage|phage
gargle|gargle
backstreet|backstreet
grungy|grungy
selector|selector
gravitationally|gravitationally
yelling|yelling
dogfight|dogfight
bilge|bilge
unlawfully|unlawfully
scrimp|scrimp
homologous|homologous
deleted|deleted
talcum|talcum
accusing|accusing
avow|avow
busybody|busybody
militate|militate
impeachable|impeachable
pivoting|pivoting
belligerence|belligerence
ionic|ionic
callow|callow
borer|borer
underestimation|underestimation
backstop|backstop
decorous|decorous
peeve|peeve
drudge|drudge
adjutant|adjutant
swindler|swindler
melanin|melanin
hardiness|hardiness
biophysical|biophysical
swathe|swathe
angora|angora
hypersensitive|hypersensitive
garret|garret
Virginian|Virginian
counterargument|counterargument
overemphasis|overemphasis
bobber|bobber
entranceway|entranceway
electrifying|electrifying
artificiality|artificiality
transience|transience
gesticulate|gesticulate
lemur|lemur
caption|caption
pontifical|pontifical
associational|associational
sloppiness|sloppiness
joust|joust
puppetry|puppetry
epithelium|epithelium
implantable|implantable
concord|concord
loyally|loyally
sherbet|sherbet
chagrin|chagrin
firebox|firebox
unbalance|unbalance
uncrowded|uncrowded
banded|banded
superconductivity|superconductivity
triumvirate|triumvirate
footloose|footloose
unprocessed|unprocessed
trilateral|trilateral
landholder|landholder
chauvinistic|chauvinistic
curtained|curtained
seeding|seeding
potter|potter
goiter|goiter
slammer|slammer
twiddle|twiddle
lodgepole|lodgepole
flyover|flyover
vale|vale
soothsayer|soothsayer
prostitute|prostitute
assemblyman|assemblyman
phosphorescent|phosphorescent
surfing|surfing
greeter|greeter
spiritualist|spiritualist
orthopedist|orthopedist
bassinet|bassinet
dapple|dapple
sluggishly|sluggishly
officious|officious
wheedle|wheedle
iridium|iridium
midwifery|midwifery
cheerleading|cheerleading
beatnik|beatnik
mantis|mantis
funereal|funereal
Hellenistic|Hellenistic
matchbook|matchbook
inauthentic|inauthentic
quinine|quinine
ripping|ripping
consumptive|consumptive
paramour|paramour
gate|gate
antic|antic
fancier|fancier
purebred|purebred
pigeonhole|pigeonhole
retained|retained
fluidly|fluidly
destitution|destitution
spay|spay
politic|politic
hereabouts|hereabouts
sulfurous|sulfurous
rootstock|rootstock
fathom|fathom
blab|blab
gabled|gabled
mutely|mutely
concertina|concertina
hightail|hightail
polyglot|polyglot
eschatology|eschatology
appendicitis|appendicitis
dismembered|dismembered
initial|initial
conscript|conscript
stepbrother|stepbrother
twisty|twisty
unglued|unglued
gallantly|gallantly
favourable|favourable
hypoxia|hypoxia
ignoble|ignoble
travelling|travelling
gramophone|gramophone
exploiter|exploiter
ringed|ringed
vernal|vernal
recessionary|recessionary
narrowed|narrowed
urethra|urethra
fetishism|fetishism
farmed|farmed
retardant|retardant
trenchant|trenchant
immodest|immodest
repartee|repartee
lemongrass|lemongrass
laughingstock|laughingstock
crybaby|crybaby
squirm|squirm
chit|chit
pup|pup
duffle|duffle
sunburst|sunburst
wraith|wraith
tiredly|tiredly
headwind|headwind
epistolary|epistolary
loquacious|loquacious
batik|batik
gamesmanship|gamesmanship
Punjabi|Punjabi
counterbalance|counterbalance
gallstone|gallstone
organza|organza
instigation|instigation
ochre|ochre
ephedra|ephedra
sugared|sugared
daintily|daintily
boomtown|boomtown
advisement|advisement
marquis|marquis
laze|laze
switchblade|switchblade
hypersensitivity|hypersensitivity
unaffordable|unaffordable
arbitrate|arbitrate
clunk|clunk
matriculate|matriculate
homeostasis|homeostasis
whodunit|whodunit
revaluation|revaluation
hypersonic|hypersonic
besmirch|besmirch
marcel|marcel
grumbling|grumbling
billows|billows
procreative|procreative
fictionalize|fictionalize
degrading|degrading
effete|effete
crimp|crimp
threateningly|threateningly
Augustinian|Augustinian
flared|flared
torsional|torsional
flatbread|flatbread
outplay|outplay
pictograph|pictograph
raceway|raceway
acquisitive|acquisitive
azimuth|azimuth
thermals|thermals
Namibian|Namibian
corporatism|corporatism
biggie|biggie
workgroup|workgroup
imperiled|imperiled
hopefulness|hopefulness
eutrophication|eutrophication
coven|coven
crocheted|crocheted
topping|topping
centurion|centurion
misspelling|misspelling
billowy|billowy
picket|picket
charitably|charitably
humvee|humvee
roadshow|roadshow
flapping|flapping
magnifier|magnifier
businessperson|businessperson
salve|salve
compassionately|compassionately
jiffy|jiffy
zookeeper|zookeeper
Arthurian|Arthurian
languorous|languorous
lye|lye
alliteration|alliteration
pushcart|pushcart
placer|placer
sharpener|sharpener
canker|canker
Torah|Torah
prefect|prefect
recording|recording
thumping|thumping
abrogation|abrogation
flimsy|flimsy
hollowness|hollowness
unclench|unclench
turgid|turgid
sty|sty
rebate|rebate
crinkly|crinkly
vac|vac
oleander|oleander
jauntily|jauntily
doughy|doughy
reification|reification
erythema|erythema
marzipan|marzipan
mudflat|mudflat
Moravian|Moravian
protozoan|protozoan
stabilized|stabilized
upright|upright
vexation|vexation
sassafras|sassafras
insouciance|insouciance
hopscotch|hopscotch
operable|operable
bookworm|bookworm
banknote|banknote
nonagricultural|nonagricultural
bafflement|bafflement
confederacy|confederacy
gravedigger|gravedigger
dispirit|dispirit
misogynistic|misogynistic
bunion|bunion
exegetical|exegetical
immunologist|immunologist
unburned|unburned
parochialism|parochialism
aeronautics|aeronautics
smuggled|smuggled
unspeakably|unspeakably
bipedal|bipedal
classifieds|classifieds
disembody|disembody
phi|phi
cretin|cretin
amelioration|amelioration
pontificate|pontificate
troika|troika
swale|swale
cornered|cornered
bubonic|bubonic
guano|guano
roan|roan
melt|melt
fusillade|fusillade
scruff|scruff
yodel|yodel
paperless|paperless
chaparral|chaparral
addled|addled
hearted|hearted
rehydrate|rehydrate
rhesus|rhesus
sightseer|sightseer
allowed|allowed
cryptography|cryptography
corrupted|corrupted
comradeship|comradeship
undesired|undesired
shim|shim
superposition|superposition
dodo|dodo
unavailability|unavailability
pilaster|pilaster
flutist|flutist
cheapskate|cheapskate
lox|lox
baldly|baldly
sheltering|sheltering
belly|belly
fiendish|fiendish
glory|glory
interwoven|interwoven
doomsayer|doomsayer
viscera|viscera
plait|plait
refining|refining
regularize|regularize
bookmaker|bookmaker
lovesick|lovesick
voyageur|voyageur
dpi|dpi
brucellosis|brucellosis
Mississippian|Mississippian
jib|jib
prismatic|prismatic
hemorrhagic|hemorrhagic
shingled|shingled
nobody|nobody
chillingly|chillingly
totemic|totemic
missionary|missionary
haw|haw
goalpost|goalpost
overvalued|overvalued
seaward|seaward
jibe|jibe
bioweapon|bioweapon
sobriquet|sobriquet
demolished|demolished
sluggishness|sluggishness
blowtorch|blowtorch
jackknife|jackknife
indicated|indicated
Sunbelt|Sunbelt
prioritization|prioritization
beveled|beveled
myrrh|myrrh
territoriality|territoriality
playable|playable
tangentially|tangentially
proofread|proofread
archrival|archrival
surmise|surmise
stalagmite|stalagmite
fantasia|fantasia
plebe|plebe
nonrefundable|nonrefundable
honorific|honorific
helpfulness|helpfulness
systematics|systematics
unjustifiable|unjustifiable
falconer|falconer
hundredfold|hundredfold
highlighted|highlighted
impeller|impeller
electromagnetism|electromagnetism
paediatrician|paediatrician
issuing|issuing
jinx|jinx
typhus|typhus
adieu|adieu
crabapple|crabapple
worshipful|worshipful
transmutation|transmutation
preeminently|preeminently
adios|adios
kickball|kickball
oscillating|oscillating
lepton|lepton
peal|peal
daikon|daikon
quintessence|quintessence
constructor|constructor
flounce|flounce
breakaway|breakaway
dildo|dildo
reprocess|reprocess
interpolation|interpolation
databank|databank
spitball|spitball
encroaching|encroaching
pinafore|pinafore
zydeco|zydeco
parathyroid|parathyroid
copiously|copiously
negativism|negativism
heuristics|heuristics
colonialist|colonialist
anklet|anklet
proboscis|proboscis
matriarchal|matriarchal
capo|capo
whitefly|whitefly
speedster|speedster
lithograph|lithograph
woodlot|woodlot
herewith|herewith
copyist|copyist
rasa|rasa
uncontaminated|uncontaminated
sleepwalker|sleepwalker
cupid|cupid
pecker|pecker
pommel|pommel
syncopated|syncopated
whistling|whistling
brownfield|brownfield
lacuna|lacuna
regional|regional
caregiving|caregiving
intersubjective|intersubjective
webmaster|webmaster
stifled|stifled
vivo|vivo
intermix|intermix
Koranic|Koranic
atomize|atomize
legitimization|legitimization
unrated|unrated
sauropod|sauropod
histopathologic|histopathologic
amaranth|amaranth
scoliosis|scoliosis
salable|salable
rebelliousness|rebelliousness
scriptwriter|scriptwriter
steers|steers
prescience|prescience
tractable|tractable
monarchical|monarchical
aeroplane|aeroplane
upwelling|upwelling
quatrain|quatrain
glycerin|glycerin
choreographed|choreographed
sounder|sounder
attractant|attractant
teetering|teetering
cliffside|cliffside
earache|earache
emotionalism|emotionalism
grooming|grooming
encephalopathy|encephalopathy
regally|regally
disorienting|disorienting
negligently|negligently
malleability|malleability
importing|importing
instantiate|instantiate
unbind|unbind
stave|stave
scarab|scarab
homogenized|homogenized
aperitif|aperitif
regrow|regrow
commercialized|commercialized
canoeist|canoeist
signaling|signaling
bevel|bevel
hanker|hanker
bootleg|bootleg
botulinum|botulinum
operetta|operetta
misdirected|misdirected
borderless|borderless
suture|suture
graying|graying
starlike|starlike
autobahn|autobahn
deliveryman|deliveryman
underpaid|underpaid
airframe|airframe
vertex|vertex
nectarine|nectarine
flowerbed|flowerbed
whimsically|whimsically
slalom|slalom
boosterism|boosterism
deforested|deforested
hovercraft|hovercraft
derriere|derriere
dilated|dilated
disrupter|disrupter
picked|picked
obeisance|obeisance
phantasm|phantasm
legless|legless
bratwurst|bratwurst
biofilm|biofilm
pendulous|pendulous
cooper|cooper
minuet|minuet
militarist|militarist
omnipresence|omnipresence
kaput|kaput
unbridgeable|unbridgeable
crapshoot|crapshoot
redistricting|redistricting
bowing|bowing
metallurgical|metallurgical
ostentation|ostentation
offending|offending
conjugation|conjugation
rapier|rapier
omnivorous|omnivorous
combustor|combustor
cabling|cabling
reclassification|reclassification
appraised|appraised
larch|larch
cultist|cultist
facetiously|facetiously
befuddle|befuddle
temptress|temptress
scofflaw|scofflaw
hoodoo|hoodoo
acoustically|acoustically
privateer|privateer
gizzard|gizzard
grueling|grueling
bucking|bucking
regency|regency
waft|waft
twang|twang
tush|tush
subroutine|subroutine
rushed|rushed
Wilsonian|Wilsonian
computerize|computerize
wallboard|wallboard
gaffer|gaffer
singleton|singleton
gourmand|gourmand
resupply|resupply
Eritrean|Eritrean
thusly|thusly
lovelorn|lovelorn
truncheon|truncheon
foreknowledge|foreknowledge
caldron|caldron
banquet|banquet
deaconess|deaconess
remonstrate|remonstrate
improbability|improbability
icily|icily
heritable|heritable
downgrading|downgrading
nutrient|nutrient
shutter|shutter
vindictiveness|vindictiveness
marvellous|marvellous
hydrated|hydrated
haemorrhage|haemorrhage
rhapsodic|rhapsodic
prolongation|prolongation
Oregonian|Oregonian
hydroponic|hydroponic
fossilize|fossilize
bioethicist|bioethicist
Babylonian|Babylonian
wondrously|wondrously
urinalysis|urinalysis
trattoria|trattoria
seized|seized
invitee|invitee
speckle|speckle
landline|landline
wisecrack|wisecrack
franchiser|franchiser
undernourished|undernourished
snigger|snigger
cane|cane
unalterable|unalterable
rehash|rehash
meddling|meddling
biohazard|biohazard
hoodie|hoodie
psychically|psychically
toile|toile
stinker|stinker
sissy|sissy
laughably|laughably
shellac|shellac
bioscience|bioscience
nonconformity|nonconformity
cacophonous|cacophonous
beanstalk|beanstalk
retributive|retributive
grandmotherly|grandmotherly
haggling|haggling
unstuck|unstuck
agog|agog
rentier|rentier
universalistic|universalistic
ambitiously|ambitiously
shuffleboard|shuffleboard
disputation|disputation
ostinato|ostinato
compounded|compounded
yap|yap
particularistic|particularistic
crackers|crackers
pebbled|pebbled
nihilist|nihilist
bifurcate|bifurcate
trembling|trembling
customizable|customizable
interventionist|interventionist
intellectualism|intellectualism
overindulge|overindulge
premade|premade
cudgel|cudgel
canvass|canvass
sobbing|sobbing
repugnance|repugnance
magnetize|magnetize
clothed|clothed
gorgonzola|gorgonzola
dickens|dickens
nothing|nothing
ambassadorship|ambassadorship
blotchy|blotchy
doodad|doodad
protectiveness|protectiveness
spawner|spawner
wipeout|wipeout
thereupon|thereupon
pseudoscience|pseudoscience
jute|jute
doyenne|doyenne
nucleon|nucleon
enveloping|enveloping
reddened|reddened
intranasal|intranasal
hieroglyphic|hieroglyphic
punctured|punctured
evaporator|evaporator
unsurprised|unsurprised
shipwreck|shipwreck
unrepresented|unrepresented
prequel|prequel
crosscut|crosscut
heparin|heparin
excepting|excepting
airily|airily
asymptotic|asymptotic
largo|largo
enigmatically|enigmatically
deltoid|deltoid
steepness|steepness
saggy|saggy
gunfighter|gunfighter
racecourse|racecourse
touristy|touristy
aurally|aurally
luger|luger
syringe|syringe
cupful|cupful
plasmid|plasmid
booker|booker
unvarying|unvarying
sandlot|sandlot
dolt|dolt
enviously|enviously
isotopic|isotopic
warpath|warpath
orthopedics|orthopedics
showboat|showboat
cadaveric|cadaveric
monied|monied
exfoliate|exfoliate
fingerprinting|fingerprinting
peacemaking|peacemaking
endolymphatic|endolymphatic
biometrics|biometrics
procedurally|procedurally
psychotherapeutic|psychotherapeutic
cultic|cultic
undercarriage|undercarriage
photoelectric|photoelectric
emancipated|emancipated
eugenic|eugenic
unranked|unranked
unrehearsed|unrehearsed
retinol|retinol
extrajudicial|extrajudicial
dilatory|dilatory
godparent|godparent
ambrosia|ambrosia
mandala|mandala
crate|crate
augmented|augmented
unloaded|unloaded
trippy|trippy
anthropomorphism|anthropomorphism
twitching|twitching
sociologically|sociologically
tyrannosaur|tyrannosaur
clairvoyance|clairvoyance
pharaonic|pharaonic
uncompleted|uncompleted
encirclement|encirclement
percutaneous|percutaneous
selflessly|selflessly
monumentally|monumentally
campo|campo
paperboy|paperboy
pig|pig
duplex|duplex
pungency|pungency
col|col
spearmint|spearmint
carpaccio|carpaccio
disquisition|disquisition
codger|codger
drowse|drowse
trivialization|trivialization
outfox|outfox
paunchy|paunchy
abstinent|abstinent
sexton|sexton
toke|toke
animating|animating
intercity|intercity
ganache|ganache
multistage|multistage
roseate|roseate
piddling|piddling
sexualized|sexualized
loamy|loamy
choked|choked
penitent|penitent
flycatcher|flycatcher
baklava|baklava
bobblehead|bobblehead
beside|beside
italicize|italicize
heraldic|heraldic
cybernetics|cybernetics
relinquishment|relinquishment
hydroxyl|hydroxyl
pickax|pickax
panfish|panfish
preachy|preachy
handcart|handcart
kaffir|kaffir
excellently|excellently
immunohistochemical|immunohistochemical
vouchsafe|vouchsafe
odorous|odorous
inculcation|inculcation
wrangle|wrangle
cognizance|cognizance
sunless|sunless
obliviousness|obliviousness
jarred|jarred
rhetorician|rhetorician
dustpan|dustpan
Edenic|Edenic
sextet|sextet
combinatorial|combinatorial
substratum|substratum
presumptively|presumptively
horsemanship|horsemanship
scrapie|scrapie
hidalgo|hidalgo
slashed|slashed
softy|softy
chaebol|chaebol
rationalistic|rationalistic
thrip|thrip
recognizance|recognizance
confusingly|confusingly
multitudinous|multitudinous
peptic|peptic
homepage|homepage
mudroom|mudroom
scramble|scramble
creamer|creamer
thud|thud
disputant|disputant
continence|continence
baluster|baluster
periodization|periodization
behaviorism|behaviorism
merino|merino
feminized|feminized
scraping|scraping
betwixt|betwixt
raving|raving
windowed|windowed
adsorption|adsorption
overcooked|overcooked
shew|shew
preformed|preformed
investiture|investiture
guideway|guideway
birdcage|birdcage
cruciform|cruciform
scintilla|scintilla
keiretsu|keiretsu
voiced|voiced
penury|penury
misappropriate|misappropriate
anarchism|anarchism
yammer|yammer
capon|capon
penstemon|penstemon
choreographic|choreographic
Phoenician|Phoenician
monumentality|monumentality
brownout|brownout
tricorder|tricorder
authoritarian|authoritarian
frugally|frugally
tracked|tracked
bluebonnet|bluebonnet
stylization|stylization
stagflation|stagflation
amine|amine
slipped|slipped
washerwoman|washerwoman
photoreceptor|photoreceptor
hydraulically|hydraulically
drubbing|drubbing
clawing|clawing
Doric|Doric
kola|kola
backlight|backlight
prudish|prudish
pasteurize|pasteurize
mensch|mensch
armless|armless
unpronounceable|unpronounceable
complexly|complexly
kingmaker|kingmaker
unlearned|unlearned
misanthrope|misanthrope
reanalysis|reanalysis
drowsily|drowsily
kibble|kibble
scape|scape
tentativeness|tentativeness
gearhead|gearhead
forbear|forbear
unarticulated|unarticulated
Argentinean|Argentinean
unexposed|unexposed
megalopolis|megalopolis
gunmetal|gunmetal
vented|vented
intermediate|intermediate
safehouse|safehouse
oriole|oriole
inviolability|inviolability
liven|liven
rearmament|rearmament
creel|creel
sureness|sureness
squeezed|squeezed
papillary|papillary
taproot|taproot
coarseness|coarseness
intramuscular|intramuscular
seatmate|seatmate
subjunctive|subjunctive
narc|narc
timekeeping|timekeeping
chico|chico
soteriological|soteriological
numerology|numerology
slutty|slutty
jurisprudential|jurisprudential
tuneful|tuneful
millipede|millipede
scorch|scorch
enlarger|enlarger
foolproof|foolproof
mujahideen|mujahideen
inseparably|inseparably
gradualism|gradualism
overproduce|overproduce
sonority|sonority
overbuild|overbuild
sorrel|sorrel
hedging|hedging
religionist|religionist
Amerindian|Amerindian
irreligious|irreligious
hantavirus|hantavirus
facially|facially
jingoism|jingoism
delimitation|delimitation
manikin|manikin
sainted|sainted
metadata|metadata
vaunt|vaunt
Assyrian|Assyrian
counterfactual|counterfactual
hillbilly|hillbilly
shabbily|shabbily
unfreeze|unfreeze
disinvestment|disinvestment
shul|shul
graywater|graywater
handstand|handstand
carnivalesque|carnivalesque
mendacious|mendacious
medico|medico
ironstone|ironstone
parry|parry
hankering|hankering
unframed|unframed
rezoning|rezoning
honourable|honourable
picketer|picketer
rampaging|rampaging
bobbin|bobbin
dispositive|dispositive
grumpily|grumpily
bowstring|bowstring
necropolis|necropolis
osmotic|osmotic
clerkship|clerkship
tribune|tribune
Palladian|Palladian
gladiolus|gladiolus
babbling|babbling
sibilant|sibilant
lustre|lustre
wadi|wadi
paraplegia|paraplegia
capably|capably
dishwashing|dishwashing
underfunding|underfunding
videocamera|videocamera
longbow|longbow
machining|machining
imprecation|imprecation
Pythagorean|Pythagorean
diptych|diptych
mooring|mooring
bravo|bravo
gaining|gaining
synchronic|synchronic
defile|defile
maidservant|maidservant
dweeb|dweeb
trespassing|trespassing
froggy|froggy
magnetar|magnetar
ambassadorial|ambassadorial
streptococcus|streptococcus
imperium|imperium
drake|drake
retitle|retitle
shitload|shitload
porker|porker
cozy|cozy
crafter|crafter
womanizing|womanizing
terabyte|terabyte
robotically|robotically
grooved|grooved
cauterize|cauterize
backspin|backspin
macaque|macaque
backstory|backstory
skittle|skittle
unproved|unproved
survivable|survivable
exceptionality|exceptionality
jubilantly|jubilantly
virtuosic|virtuosic
ruled|ruled
thawed|thawed
companionway|companionway
molehill|molehill
peacenik|peacenik
crew|crew
dressage|dressage
eats|eats
smilingly|smilingly
absinthe|absinthe
sopping|sopping
dong|dong
simpering|simpering
unrelentingly|unrelentingly
trouper|trouper
shorn|shorn
towpath|towpath
billow|billow
libelous|libelous
unindicted|unindicted
supplied|supplied
bioavailability|bioavailability
pyrite|pyrite
honking|honking
corpsman|corpsman
gape|gape
jewellery|jewellery
townsman|townsman
ghee|ghee
uncircumcised|uncircumcised
lawmaking|lawmaking
paladin|paladin
snooker|snooker
detained|detained
reflectance|reflectance
anchored|anchored
workpiece|workpiece
statism|statism
singleness|singleness
raucously|raucously
loess|loess
consumable|consumable
lessened|lessened
massing|massing
crook|crook
outwork|outwork
truculent|truculent
fungible|fungible
psychobabble|psychobabble
uncorroborated|uncorroborated
creaturely|creaturely
slum|slum
Orientalist|Orientalist
viva|viva
pipsqueak|pipsqueak
bordering|bordering
bicoastal|bicoastal
ninny|ninny
melaleuca|melaleuca
syntactical|syntactical
peevishly|peevishly
geomagnetic|geomagnetic
bonk|bonk
tussock|tussock
narrowing|narrowing
notational|notational
sheer|sheer
forecourt|forecourt
broil|broil
doyen|doyen
pastoralism|pastoralism
selectman|selectman
tragicomic|tragicomic
warfarin|warfarin
unimproved|unimproved
inducer|inducer
noncommittally|noncommittally
tabla|tabla
quaintly|quaintly
cryptographic|cryptographic
archdiocesan|archdiocesan
neutering|neutering
spangle|spangle
slothful|slothful
suss|suss
transgendered|transgendered
battlefront|battlefront
glaciation|glaciation
teensy|teensy
fueled|fueled
chug|chug
radicalized|radicalized
misrule|misrule
Patagonian|Patagonian
unendurable|unendurable
boomlet|boomlet
sauce|sauce
wheezing|wheezing
regress|regress
antique|antique
fading|fading
methylmercury|methylmercury
loosestrife|loosestrife
dialing|dialing
antifeminist|antifeminist
polygyny|polygyny
moistness|moistness
revamp|revamp
handshaking|handshaking
wonky|wonky
splintering|splintering
thereon|thereon
hetero|hetero
demitasse|demitasse
unleavened|unleavened
backflip|backflip
bollock|bollock
fantasyland|fantasyland
antitoxin|antitoxin
blushing|blushing
fainting|fainting
apostolate|apostolate
sturdily|sturdily
babbling|babbling
alopecia|alopecia
tautly|tautly
slipping|slipping
staying|staying
anthracite|anthracite
voile|voile
changeless|changeless
scorned|scorned
polymorphous|polymorphous
stroma|stroma
elocution|elocution
muchacho|muchacho
sandman|sandman
credentialed|credentialed
remodeler|remodeler
personified|personified
franchisor|franchisor
whirligig|whirligig
Rastafarian|Rastafarian
chewable|chewable
kudu|kudu
chirpy|chirpy
weekender|weekender
batsman|batsman
pollack|pollack
articulately|articulately
anodyne|anodyne
combed|combed
Constructivist|Constructivist
spellbinding|spellbinding
sociobiology|sociobiology
sacral|sacral
mimeographed|mimeographed
irritatingly|irritatingly
natter|natter
conflictive|conflictive
tipster|tipster
photonics|photonics
Sisyphean|Sisyphean
devoutly|devoutly
codicil|codicil
supernaturally|supernaturally
awesomely|awesomely
Kafkaesque|Kafkaesque
beeping|beeping
dogsled|dogsled
teletype|teletype
counteroffer|counteroffer
aerodynamically|aerodynamically
bouffant|bouffant
oedema|oedema
blending|blending
dabbler|dabbler
phosphoric|phosphoric
icehouse|icehouse
scotch|scotch
appreciated|appreciated
pawnbroker|pawnbroker
boozer|boozer
frowning|frowning
millenarian|millenarian
blade|blade
sealskin|sealskin
chesterfield|chesterfield
bucketful|bucketful
soundscape|soundscape
ester|ester
pinewood|pinewood
styler|styler
grating|grating
colostrum|colostrum
schmaltzy|schmaltzy
whosoever|whosoever
proprietress|proprietress
hatbox|hatbox
obverse|obverse
reappraise|reappraise
backgrounder|backgrounder
catbird|catbird
lux|lux
addressed|addressed
Malaysian|Malaysian
chicken|chicken
denuded|denuded
gayness|gayness
cheerleading|cheerleading
brain|brain
ductile|ductile
muumuu|muumuu
tastemaker|tastemaker
unreasoning|unreasoning
searchingly|searchingly
imponderable|imponderable
rationalized|rationalized
squiggle|squiggle
frogman|frogman
brightening|brightening
metier|metier
antonym|antonym
ulcerated|ulcerated
mastic|mastic
blackfly|blackfly
glowering|glowering
overwintering|overwintering
dauntingly|dauntingly
unreservedly|unreservedly
restyle|restyle
consolidator|consolidator
leftward|leftward
dearie|dearie
bitumen|bitumen
dimensionless|dimensionless
corkboard|corkboard
papoose|papoose
spasticity|spasticity
dynamite|dynamite
plundering|plundering
theoretic|theoretic
primed|primed
asymmetrically|asymmetrically
gerrymandering|gerrymandering
sheer|sheer
dimming|dimming
encoding|encoding
hydrochloride|hydrochloride
wiggly|wiggly
barberry|barberry
oversensitive|oversensitive
contortionist|contortionist
whelk|whelk
combativeness|combativeness
spotlessly|spotlessly
cremated|cremated
canasta|canasta
brainwave|brainwave
leaching|leaching
jockstrap|jockstrap
mala|mala
attender|attender
handmaid|handmaid
garrote|garrote
sward|sward
peoplehood|peoplehood
chaparral|chaparral
embellished|embellished
baud|baud
swain|swain
corroborative|corroborative
hurting|hurting
chamberlain|chamberlain
obsessiveness|obsessiveness
straggling|straggling
caries|caries
glutamine|glutamine
unhampered|unhampered
resistivity|resistivity
bareback|bareback
incompetent|incompetent
sultanate|sultanate
flammability|flammability
delectation|delectation
galette|galette
meetinghouse|meetinghouse
phoney|phoney
posed|posed
worsted|worsted
webpage|webpage
poky|poky
splotchy|splotchy
glitterati|glitterati
mapper|mapper
clonal|clonal
fluorocarbon|fluorocarbon
depressant|depressant
debilitated|debilitated
recondite|recondite
erg|erg
hellion|hellion
retrievable|retrievable
unverifiable|unverifiable
invalidation|invalidation
carom|carom
chooser|chooser
dishcloth|dishcloth
skipping|skipping
lodestar|lodestar
earthward|earthward
supersize|supersize
Zairean|Zairean
celiac|celiac
pedantry|pedantry
inspiratory|inspiratory
muchacha|muchacha
ambidextrous|ambidextrous
overgrazed|overgrazed
emptily|emptily
rebbe|rebbe
gather|gather
presentiment|presentiment
touristic|touristic
convening|convening
pardner|pardner
aspic|aspic
catsup|catsup
egoistic|egoistic
insightfully|insightfully
jailbird|jailbird
appurtenance|appurtenance
collarless|collarless
bollworm|bollworm
troller|troller
moa|moa
metrology|metrology
fermion|fermion
psychopathological|psychopathological
downshift|downshift
papilloma|papilloma
expiratory|expiratory
discriminative|discriminative
interpreting|interpreting
brashly|brashly
solubility|solubility
goddaughter|goddaughter
subspace|subspace
overstaffed|overstaffed
light|light
chirping|chirping
majolica|majolica
newel|newel
glimmering|glimmering
shredding|shredding
cosmetologist|cosmetologist
cheroot|cheroot
stubbled|stubbled
clanking|clanking
lingual|lingual
simian|simian
heliotrope|heliotrope
scythe|scythe
resurfacing|resurfacing
gorgon|gorgon
particularized|particularized
debauch|debauch
corm|corm
eider|eider
scabrous|scabrous
overheard|overheard
hydrating|hydrating
narratively|narratively
doglike|doglike
remold|remold
distractor|distractor
strutting|strutting
allopathic|allopathic
deadweight|deadweight
commonalty|commonalty
blackmailer|blackmailer
ignored|ignored
relegation|relegation
sickened|sickened
icemaker|icemaker
cosset|cosset
duodenal|duodenal
hemodynamic|hemodynamic
overestimate|overestimate
glycerine|glycerine
Jacobean|Jacobean
stultifying|stultifying
skirmishing|skirmishing
tablespoonful|tablespoonful
pretentiousness|pretentiousness
hijinks|hijinks
bookmobile|bookmobile
gluteal|gluteal
miseducation|miseducation
contour|contour
ferritin|ferritin
ticketing|ticketing
liminality|liminality
tater|tater
incantatory|incantatory
banging|banging
tuned|tuned
goy|goy
audiologic|audiologic
scram|scram
daydreaming|daydreaming
discussant|discussant
busywork|busywork
thermophilic|thermophilic
aaah|aaah
rapping|rapping
patriotically|patriotically
madder|madder
hermeneutic|hermeneutic
turbot|turbot
hoofprint|hoofprint
reshoot|reshoot
doggedness|doggedness
unembarrassed|unembarrassed
interchange|interchange
huffing|huffing
dockyard|dockyard
surfactant|surfactant
infotainment|infotainment
cognate|cognate
nattily|nattily
hosting|hosting
buffed|buffed
citron|citron
wheatgrass|wheatgrass
unclog|unclog
purloin|purloin
naughtiness|naughtiness
entombment|entombment
neurochemistry|neurochemistry
ejector|ejector
decolletage|decolletage
fixative|fixative
gesticulation|gesticulation
uninformative|uninformative
extrication|extrication
pillory|pillory
gnawing|gnawing
flyboy|flyboy
deactivation|deactivation
variegation|variegation
slithery|slithery
patronizingly|patronizingly
hoedown|hoedown
vittles|vittles
sodomite|sodomite
naphtha|naphtha
deferentially|deferentially
bellyache|bellyache
monocultural|monocultural
Senegalese|Senegalese
antimicrobial|antimicrobial
lodestone|lodestone
onrush|onrush
gasifier|gasifier
floodlit|floodlit
faery|faery
uncompressed|uncompressed
sycophantic|sycophantic
linguini|linguini
marchioness|marchioness
aerogel|aerogel
guesstimate|guesstimate
hellcat|hellcat
raving|raving
stuttering|stuttering
exiting|exiting
flameout|flameout
autoclave|autoclave
streptococci|streptococci
imbalanced|imbalanced
vocab|vocab
instrumented|instrumented
dairyman|dairyman
marrying|marrying
tidewater|tidewater
retractor|retractor
expander|expander
adverbial|adverbial
dimorphism|dimorphism
supernumerary|supernumerary
romper|romper
lionfish|lionfish
hypnotherapy|hypnotherapy
orthosis|orthosis
evisceration|evisceration
surfacing|surfacing
unhealed|unhealed
returnable|returnable
former|former
osteopathic|osteopathic
frisket|frisket
tenia|tenia
suntanned|suntanned
spud|spud
curbing|curbing
gunny|gunny
replicated|replicated
womankind|womankind
prolifically|prolifically
egoist|egoist
obtuseness|obtuseness
gimmickry|gimmickry
unreel|unreel
dystopia|dystopia
skullduggery|skullduggery
sanding|sanding
meiosis|meiosis
lacework|lacework
pieta|pieta
grey|grey
oxidase|oxidase
carob|carob
metaphysician|metaphysician
nonmagnetic|nonmagnetic
underdressed|underdressed
sportswoman|sportswoman
fogged|fogged
aerialist|aerialist
expiring|expiring
mediaeval|mediaeval
catecholamine|catecholamine
bildungsroman|bildungsroman
unappreciative|unappreciative
palpitate|palpitate
ceremonious|ceremonious
pasteboard|pasteboard
untarnished|untarnished
hanged|hanged
fibrin|fibrin
tam|tam
warlock|warlock
uninflected|uninflected
beneficially|beneficially
dimmed|dimmed
tuberous|tuberous
granita|granita
childlessness|childlessness
packinghouse|packinghouse
spitefully|spitefully
massager|massager
tutee|tutee
effortful|effortful
kimchi|kimchi
tinsel|tinsel
thoughtlessness|thoughtlessness
desalinization|desalinization
cockfight|cockfight
predication|predication
bowrider|bowrider
yippee|yippee
meanly|meanly
incisively|incisively
provincial|provincial
etiologic|etiologic
psychiatrically|psychiatrically
curandero|curandero
mycologist|mycologist
decathlete|decathlete
flunkie|flunkie
doughty|doughty
glucosamine|glucosamine
embryologist|embryologist
publican|publican
fibroid|fibroid
cellulitis|cellulitis
drib|drib
hydrofoil|hydrofoil
cytomegalovirus|cytomegalovirus
uncomprehendingly|uncomprehendingly
Cretan|Cretan
sensuousness|sensuousness
deconstructionism|deconstructionism
layaway|layaway
bodacious|bodacious
dumbo|dumbo
necropsy|necropsy
thirdhand|thirdhand
trice|trice
chigger|chigger
ornamented|ornamented
Onward|Onward
corruptible|corruptible
delineated|delineated
transfuse|transfuse
bounding|bounding
neuropsychology|neuropsychology
shuttlecock|shuttlecock
waterspout|waterspout
yonder|yonder
predestined|predestined
irresolute|irresolute
stonefly|stonefly
meandering|meandering
ticketed|ticketed
overreaching|overreaching
turpitude|turpitude
undreamed|undreamed
circumscription|circumscription
tolling|tolling
calamine|calamine
retake|retake
thenceforth|thenceforth
limbless|limbless
polymorphic|polymorphic
grandiloquent|grandiloquent
raga|raga
importune|importune
wineskin|wineskin
scald|scald
jackboot|jackboot
dimer|dimer
grayling|grayling
terrapin|terrapin
flub|flub
heliport|heliport
gameplay|gameplay
unclouded|unclouded
sullenness|sullenness
abracadabra|abracadabra
tugging|tugging
chocolatier|chocolatier
holey|holey
usurious|usurious
malevolently|malevolently
workability|workability
chambray|chambray
franchised|franchised
listenership|listenership
birdcall|birdcall
immutability|immutability
complicitous|complicitous
fledging|fledging
unsought|unsought
decider|decider
polygonal|polygonal
futz|futz
reword|reword
dredged|dredged
gringa|gringa
saturnian|saturnian
autosomal|autosomal
brilliancy|brilliancy
shipowner|shipowner
squabbling|squabbling
decalogue|decalogue
scow|scow
hortatory|hortatory
Danish|Danish
precipitator|precipitator
untiring|untiring
zoomorphic|zoomorphic
theist|theist
telegraphic|telegraphic
adoptable|adoptable
polycarbonate|polycarbonate
misinformed|misinformed
adenoidectomy|adenoidectomy
ryegrass|ryegrass
jitney|jitney
chitin|chitin
somnolence|somnolence
luxuriantly|luxuriantly
excused|excused
evilly|evilly
poplin|poplin
flagged|flagged
parastatal|parastatal
subjunctive|subjunctive
deified|deified
ammonite|ammonite
fissured|fissured
misname|misname
gracefulness|gracefulness
croaking|croaking
sinecure|sinecure
burgle|burgle
astrobiologist|astrobiologist
portion|portion
hyperextension|hyperextension
daub|daub
cephalosporin|cephalosporin
congruity|congruity
unsexy|unsexy
patrilineage|patrilineage
riotously|riotously
canopy|canopy
slaver|slaver
maths|maths
debenture|debenture
parley|parley
dermatological|dermatological
unfurnished|unfurnished
gouged|gouged
honoring|honoring
gunnel|gunnel
chintzy|chintzy
rattletrap|rattletrap
basketmaker|basketmaker
Thatcherite|Thatcherite
anointing|anointing
lipsticked|lipsticked
enumerator|enumerator
mandoline|mandoline
antinomy|antinomy
guidestar|guidestar
shatterproof|shatterproof
bestride|bestride
presidentially|presidentially
plugger|plugger
rotating|rotating
initiating|initiating
eeriness|eeriness
nonrecognition|nonrecognition
trustful|trustful
ethnicization|ethnicization
lecithin|lecithin
kahuna|kahuna
unnameable|unnameable
lumpen|lumpen
tautness|tautness
contrastive|contrastive
fancifully|fancifully
interleukin|interleukin
irremediably|irremediably
rescission|rescission
burbling|burbling
hemodialysis|hemodialysis
asteroidal|asteroidal
conceptualist|conceptualist
factuality|factuality
misaligned|misaligned
cautery|cautery
assonance|assonance
prebiotic|prebiotic
scorekeeper|scorekeeper
batted|batted
waitstaff|waitstaff
externalization|externalization
perspicacity|perspicacity
greasepaint|greasepaint
empanel|empanel
pone|pone
monotonic|monotonic
timeshare|timeshare
revetment|revetment
hosting|hosting
problematically|problematically
excreta|excreta
gristmill|gristmill
tomfoolery|tomfoolery
rhomboid|rhomboid
telemedicine|telemedicine
playgoer|playgoer
loden|loden
cartload|cartload
exculpate|exculpate
touring|touring
counterforce|counterforce
joyride|joyride
subarachnoid|subarachnoid
lockable|lockable
fencerow|fencerow
pasturage|pasturage
plainclothesman|plainclothesman
shearing|shearing
enduringly|enduringly
venturi|venturi
maternally|maternally
lamplit|lamplit
mustiness|mustiness
giantess|giantess
underperforming|underperforming
insensate|insensate
glissando|glissando
impactful|impactful
interruptible|interruptible
anticonvulsant|anticonvulsant
brunet|brunet
madrassah|madrassah
armhole|armhole
voracity|voracity
antedate|antedate
graviton|graviton
waggle|waggle
defacement|defacement
misnamed|misnamed
reductase|reductase
goopy|goopy
intelligibly|intelligibly
domicile|domicile
sidesaddle|sidesaddle
malnourishment|malnourishment
cursing|cursing
sourpuss|sourpuss
coonskin|coonskin
junk|junk
pitying|pitying
taxman|taxman
reproduced|reproduced
submillimeter|submillimeter
coloratura|coloratura
residentially|residentially
netball|netball
planked|planked
biliary|biliary
wiggler|wiggler
demoiselle|demoiselle
channeled|channeled
bestowal|bestowal
sexualization|sexualization
demiurge|demiurge
humaneness|humaneness
translocation|translocation
kicky|kicky
pissing|pissing
ascertainable|ascertainable
mescaline|mescaline
disclosed|disclosed
extratextual|extratextual
prefectural|prefectural
unwaveringly|unwaveringly
layabout|layabout
trial|trial
ballcarrier|ballcarrier
roiling|roiling
aerodigestive|aerodigestive
methionine|methionine
smartass|smartass
cog|cog
gutter|gutter
Slav|Slav
robbing|robbing
andante|andante
protuberant|protuberant
niobium|niobium
covetousness|covetousness
Manichaean|Manichaean
harissa|harissa
mycobacterial|mycobacterial
patrician|patrician
salver|salver
papist|papist
dorado|dorado
hypnotism|hypnotism
Tahitian|Tahitian
shopgirl|shopgirl
braying|braying
charmless|charmless
metallic|metallic
overdeveloped|overdeveloped
uvula|uvula
sociobiologist|sociobiologist
glockenspiel|glockenspiel
cava|cava
starfield|starfield
pointlessness|pointlessness
reprobate|reprobate
rounders|rounders
decoded|decoded
supplicate|supplicate
gasbag|gasbag
tobacconist|tobacconist
gorget|gorget
oddment|oddment
prevaricate|prevaricate
animality|animality
nutraceutical|nutraceutical
riddled|riddled
bandbox|bandbox
compleat|compleat
Sahelian|Sahelian
Hittite|Hittite
imagistic|imagistic
dodging|dodging
caulking|caulking
phonebook|phonebook
advantageously|advantageously
recalibration|recalibration
monomaniacal|monomaniacal
Czarist|Czarist
nailed|nailed
laryngoscope|laryngoscope
copybook|copybook
stewpot|stewpot
foppish|foppish
carnelian|carnelian
carryall|carryall
bilateralism|bilateralism
inexpressive|inexpressive
fatiguing|fatiguing
ionizing|ionizing
syphilitic|syphilitic
perceivable|perceivable
videocam|videocam
partyer|partyer
shrimping|shrimping
Corsican|Corsican
fantasist|fantasist
Thracian|Thracian
preconquest|preconquest
marchese|marchese
technics|technics
ballooning|ballooning
Stradivarius|Stradivarius
cautiousness|cautiousness
codpiece|codpiece
kaffiyeh|kaffiyeh
allen|allen
inquisitively|inquisitively
hemolytic|hemolytic
sleepwalking|sleepwalking
headspace|headspace
darnedest|darnedest
toniest|toniest
furrier|furrier
hireling|hireling
decongestant|decongestant
periosteum|periosteum
damply|damply
hasp|hasp
disorder|disorder
stegosaurus|stegosaurus
hematocrit|hematocrit
quantized|quantized
dowser|dowser
froufrou|froufrou
unpracticed|unpracticed
esthetically|esthetically
smutty|smutty
flatworm|flatworm
scrollwork|scrollwork
truckstop|truckstop
reoccupation|reoccupation
turbofan|turbofan
micromachine|micromachine
mansard|mansard
neurophysiology|neurophysiology
gilding|gilding
innervation|innervation
geoeconomic|geoeconomic
unchosen|unchosen
mechanical|mechanical
oxygenate|oxygenate
lubricious|lubricious
Catalonian|Catalonian
Rhenish|Rhenish
buffered|buffered
verdure|verdure
pinking|pinking
fatso|fatso
driverless|driverless
webby|webby
debe|debe
busk|busk
organochlorine|organochlorine
chatelaine|chatelaine
cockerel|cockerel
biped|biped
derisory|derisory
laughing|laughing
salaam|salaam
astrometric|astrometric
ultima|ultima
gunrunner|gunrunner
moonlet|moonlet
deviously|deviously
affronted|affronted
dingbat|dingbat
darkish|darkish
Neandertal|Neandertal
grayed|grayed
banyan|banyan
nonporous|nonporous
engorgement|engorgement
cabalistic|cabalistic
artfulness|artfulness
therewith|therewith
multileveled|multileveled
pressroom|pressroom
crooning|crooning
decadal|decadal
hepatocellular|hepatocellular
plebeian|plebeian
merrymaking|merrymaking
commendably|commendably
zoonotic|zoonotic
bohemia|bohemia
kilim|kilim
arrant|arrant
dieldrin|dieldrin
neurogenic|neurogenic
laver|laver
schoolbus|schoolbus
contemporaneity|contemporaneity
highboy|highboy
lightheartedness|lightheartedness
summoning|summoning
pleural|pleural
dysphonia|dysphonia
champaign|champaign
tropical|tropical
junto|junto
serried|serried
hacendado|hacendado
calcareous|calcareous
shuddering|shuddering
inactivated|inactivated
kneaded|kneaded
posada|posada
blondish|blondish
routinization|routinization
hadrosaur|hadrosaur
distastefully|distastefully
spastically|spastically
elate|elate
peritonsillar|peritonsillar
punctually|punctually
tended|tended
hagiographic|hagiographic
squareness|squareness
adiabatic|adiabatic
gosling|gosling
palindrome|palindrome
connexion|connexion
paediatrics|paediatrics
nailhead|nailhead
drabness|drabness
boxful|boxful
baptistery|baptistery
tunesmith|tunesmith
protectant|protectant
gloating|gloating
multiprocessor|multiprocessor
ubiquitously|ubiquitously
masticate|masticate
adventitious|adventitious
ampoule|ampoule
neuroendocrine|neuroendocrine
spaetzle|spaetzle
astuteness|astuteness
amoebic|amoebic
diplomate|diplomate
grogginess|grogginess
dudgeon|dudgeon
squelching|squelching
retracted|retracted
incompetently|incompetently
wanker|wanker
crofter|crofter
lovely|lovely
lingcod|lingcod
spectacular|spectacular
nasogastric|nasogastric
nisei|nisei
axonal|axonal
witchery|witchery
promenade|promenade
pushrod|pushrod
meteoroid|meteoroid
espy|espy
dromedary|dromedary
opacification|opacification
ipecac|ipecac
southward|southward
drenching|drenching
undecipherable|undecipherable
hypercar|hypercar
houri|houri
tunelessly|tunelessly
piebald|piebald
glottis|glottis
bioaccumulation|bioaccumulation
yawl|yawl
fizzing|fizzing
predecease|predecease
bookbinder|bookbinder
rapeseed|rapeseed
crassness|crassness
plantsman|plantsman
isomorphic|isomorphic
swarming|swarming
lanolin|lanolin
armour|armour
relinquishing|relinquishing
abstractedly|abstractedly
okapi|okapi
delegative|delegative
egocentricity|egocentricity
spectroscope|spectroscope
disproportional|disproportional
guayabera|guayabera
giveback|giveback
preeminent|preeminent
unfurling|unfurling
gingered|gingered
thromboembolism|thromboembolism
refashioning|refashioning
switchover|switchover
bacchanalia|bacchanalia
metalhead|metalhead
ringless|ringless
mesoscopic|mesoscopic
stripping|stripping
barreled|barreled
disciplining|disciplining
contritely|contritely
hyperparathyroidism|hyperparathyroidism
magnetics|magnetics
rockfall|rockfall
woozily|woozily
deceiving|deceiving
adventurousness|adventurousness
subclass|subclass
principalship|principalship
manoeuvre|manoeuvre
parasitical|parasitical
favoring|favoring
deliverymen|deliverymen
talentless|talentless
aerobatic|aerobatic
aphelion|aphelion
objectivism|objectivism
symbiotically|symbiotically
trollop|trollop
excisional|excisional
cowpox|cowpox
ensuite|ensuite
portcullis|portcullis
fancied|fancied
disconcerted|disconcerted
evenhandedly|evenhandedly
ditsy|ditsy
circumstantially|circumstantially
conventionalized|conventionalized
sepulchre|sepulchre
charting|charting
bagasse|bagasse
guanine|guanine
hunchbacked|hunchbacked
coltish|coltish
macerate|macerate
pimpled|pimpled
spotlighted|spotlighted
idled|idled
overdevelop|overdevelop
interiorize|interiorize
novelization|novelization
petrous|petrous
Hanseatic|Hanseatic
biowarfare|biowarfare
dreaminess|dreaminess
rifling|rifling
opaquely|opaquely
mocking|mocking
bobble|bobble
injera|injera
vasoconstrictor|vasoconstrictor
cordovan|cordovan
nicker|nicker
disapprobation|disapprobation
provoking|provoking
headlining|headlining
plotless|plotless
Yemenite|Yemenite
sulphuric|sulphuric
abusively|abusively
recalling|recalling
misquote|misquote
frosh|frosh
quadruped|quadruped
divorcing|divorcing
fluoridated|fluoridated
seemly|seemly
vacillating|vacillating
replicant|replicant
cruet|cruet
farrago|farrago
prophylactic|prophylactic
vocationally|vocationally
presider|presider
estancia|estancia
Iroquoian|Iroquoian
mycobacteria|mycobacteria
gleanings|gleanings
indecently|indecently
surmountable|surmountable
lethargically|lethargically
unkindness|unkindness
wavery|wavery
rumen|rumen
stroboscopic|stroboscopic
pulsatile|pulsatile
interconnectivity|interconnectivity
subjectivist|subjectivist
lysis|lysis
vomiting|vomiting
commoditization|commoditization
undiplomatic|undiplomatic
proselytizing|proselytizing
rending|rending
honeycombed|honeycombed
presbyopia|presbyopia
ruminant|ruminant
bleeding|bleeding
eastward|eastward
sensate|sensate
scrunchie|scrunchie
translocal|translocal
wigeon|wigeon
dehumanized|dehumanized
travail|travail
firelit|firelit
reinvestigate|reinvestigate
corbel|corbel
syntactically|syntactically
legionary|legionary
beckoning|beckoning
axilla|axilla
disfavored|disfavored
bathetic|bathetic
alluringly|alluringly
impotently|impotently
uncontainable|uncontainable
faille|faille
shiso|shiso
compulsiveness|compulsiveness
neutralizing|neutralizing
bollard|bollard
systematization|systematization
leukotriene|leukotriene
bedded|bedded
electromyography|electromyography
reprieve|reprieve
neurasthenic|neurasthenic
sung|sung
impassivity|impassivity
acequia|acequia
indigence|indigence
trackside|trackside
downloading|downloading
Revisionist|Revisionist
centralist|centralist
posing|posing
fuzzily|fuzzily
unwired|unwired
Parthian|Parthian
sheathed|sheathed
supercharge|supercharge
purgative|purgative
incorruptibility|incorruptibility
mutagenic|mutagenic
sulking|sulking
lipped|lipped
surcoat|surcoat
recounted|recounted
ticketing|ticketing
passive|passive
brusqueness|brusqueness
deflator|deflator
heedlessness|heedlessness
premiere|premiere
gastronome|gastronome
ravel|ravel
sleeved|sleeved
sandpit|sandpit
malamute|malamute
lavishness|lavishness
tearless|tearless
apparat|apparat
fishwife|fishwife
sabra|sabra
edibility|edibility
biomolecular|biomolecular
iodized|iodized
arthroscopy|arthroscopy
orbital|orbital
grapeseed|grapeseed
piquancy|piquancy
coalescing|coalescing
clumping|clumping
attacked|attacked
humorlessly|humorlessly
sectional|sectional
aseptically|aseptically
gazette|gazette
muskmelon|muskmelon
Atlantean|Atlantean
distributing|distributing
unpleasantry|unpleasantry
ineffably|ineffably
epiphanic|epiphanic
benefactress|benefactress
picosecond|picosecond
achromatic|achromatic
beechnut|beechnut
practicability|practicability
spookily|spookily
jazzman|jazzman
tamely|tamely
housetop|housetop
judged|judged
kabbalah|kabbalah
nonvolatile|nonvolatile
rootworm|rootworm
masculine|masculine
saurian|saurian
concubinage|concubinage
squeezer|squeezer
theorized|theorized
uncelebrated|uncelebrated
revengeful|revengeful
cramping|cramping
interfacial|interfacial
mujahidin|mujahidin
thiamine|thiamine
sumptuary|sumptuary
blondness|blondness
oiliness|oiliness
stampeding|stampeding
forewing|forewing
cryopreservation|cryopreservation
ethereally|ethereally
haredim|haredim
surrounded|surrounded
trellised|trellised
substitutability|substitutability
schematize|schematize
spectroscopist|spectroscopist
chromodynamics|chromodynamics
guesser|guesser
exultantly|exultantly
undeservedly|undeservedly
badgering|badgering
undiscriminating|undiscriminating
verbosity|verbosity
oligopolistic|oligopolistic
prickling|prickling
osteogenesis|osteogenesis
yappy|yappy
cordage|cordage
weedbed|weedbed
heatwave|heatwave
stratigraphic|stratigraphic
unfathomably|unfathomably
assayer|assayer
nonperformance|nonperformance
Moorish|Moorish
redoubled|redoubled
antipathetic|antipathetic
griffon|griffon
pachuco|pachuco
microbrewery|microbrewery
uncrowned|uncrowned
medkit|medkit
buckthorn|buckthorn
dimorphic|dimorphic
pseudopod|pseudopod
stifling|stifling
carbonized|carbonized
forbiddingly|forbiddingly
reticulated|reticulated
babbitt|babbitt
masturbator|masturbator
outlawing|outlawing
doppler|doppler
prearrangement|prearrangement
fireback|fireback
chutzpa|chutzpa
Caledonian|Caledonian
barbless|barbless
microscopist|microscopist
nibbler|nibbler
splay|splay
isinglass|isinglass
flautist|flautist
touching|touching
slouching|slouching
jangly|jangly
erstwhile|erstwhile
thermography|thermography
proposer|proposer
underline|underline
burl|burl
phaeton|phaeton
mazy|mazy
backtalk|backtalk
kinked|kinked
capybara|capybara
zygomatic|zygomatic
cooperativeness|cooperativeness
blazon|blazon
revolutionized|revolutionized
capturing|capturing
sated|sated
codebook|codebook
incisional|incisional
demonizing|demonizing
postnational|postnational
churned|churned
thready|thready
horizontality|horizontality
triangulated|triangulated
swingset|swingset
vengefully|vengefully
blundering|blundering
questionably|questionably
eosinophilia|eosinophilia
hyperpigmentation|hyperpigmentation
histiocyte|histiocyte
collimator|collimator
braising|braising
hairdryer|hairdryer
creamware|creamware
revenge|revenge
unredeemable|unredeemable
fractionation|fractionation
transcendentally|transcendentally
geometrics|geometrics
politicizing|politicizing
transported|transported
trochanter|trochanter
unstrung|unstrung
entailment|entailment
datastream|datastream
abasement|abasement
cramming|cramming
pasting|pasting
surrendered|surrendered
Ashkenazic|Ashkenazic
romanticist|romanticist
ripcord|ripcord
kafir|kafir
samsara|samsara
livelong|livelong
cotyledon|cotyledon
specifiable|specifiable
queerly|queerly
uncolored|uncolored
creepiness|creepiness
unshielded|unshielded
dissembling|dissembling
rotgut|rotgut
clangor|clangor
reclaiming|reclaiming
ephemeris|ephemeris
recirculating|recirculating
nourished|nourished
grass|grass
queasily|queasily
dybbuk|dybbuk
maidenly|maidenly
snooper|snooper
rheostat|rheostat
airshaft|airshaft
cioppino|cioppino
bottlebrush|bottlebrush
makeable|makeable
propolis|propolis
flattish|flattish
mineshaft|mineshaft
carfare|carfare
orthopaedics|orthopaedics
hydrolyzed|hydrolyzed
villainess|villainess
walloping|walloping
encircled|encircled
ceramicist|ceramicist
slimeball|slimeball
steroidal|steroidal
oxidizing|oxidizing
Eurasian|Eurasian
deceived|deceived
superglue|superglue
lugged|lugged
clathrate|clathrate
homiletic|homiletic
wat|wat
cackling|cackling
chuckling|chuckling
windsurf|windsurf
macrocosmic|macrocosmic
voltaic|voltaic
sniveling|sniveling
possessory|possessory
sidelock|sidelock
unknowability|unknowability
learnable|learnable
gruelling|gruelling
Moonie|Moonie
prewashed|prewashed
midland|midland
bathos|bathos
clumping|clumping
cryonic|cryonic
restocking|restocking
sultana|sultana
devourer|devourer
restorationist|restorationist
comprehensibility|comprehensibility
pyromaniac|pyromaniac
fumbled|fumbled
flameproof|flameproof
bibb|bibb
redirected|redirected
draper|draper
tule|tule
pharmacognosy|pharmacognosy
mathematic|mathematic
ultraportable|ultraportable
perjurious|perjurious
medicament|medicament
tefillin|tefillin
fluoxetine|fluoxetine
Bengali|Bengali
creditably|creditably
sarsaparilla|sarsaparilla
despoliation|despoliation
puddled|puddled
preciously|preciously
smirky|smirky
palooka|palooka
neurobehavioral|neurobehavioral
kerf|kerf
nosphere|nosphere
phylactery|phylactery
thermoregulation|thermoregulation
consubstantial|consubstantial
seraph|seraph
weaponless|weaponless
chinaberry|chinaberry
canebrake|canebrake
concensus|concensus
sweepingly|sweepingly
kilohertz|kilohertz
ruck|ruck
antigenic|antigenic
psychokinesis|psychokinesis
buffeting|buffeting
expended|expended
miasmic|miasmic
oppositionist|oppositionist
apatosaurus|apatosaurus
belatedness|belatedness
uploaded|uploaded
switcheroo|switcheroo
pinging|pinging
butterflied|butterflied
submicroscopic|submicroscopic
unexcused|unexcused
paramagnetic|paramagnetic
straying|straying
catnap|catnap
abscessed|abscessed
patristics|patristics
zester|zester
conserver|conserver
imploding|imploding
misting|misting
rearranging|rearranging
bucko|bucko
voided|voided
carless|carless
sucky|sucky
lifesuit|lifesuit
abstinent|abstinent
nugatory|nugatory
spectacled|spectacled
bejeezus|bejeezus
weightiness|weightiness
autoregressive|autoregressive
flipping|flipping
raja|raja
subsea|subsea
enfranchised|enfranchised
deprogrammer|deprogrammer
cleanout|cleanout
nonpoor|nonpoor
paddlewheel|paddlewheel
skald|skald
dreamworld|dreamworld
beriberi|beriberi
plasterwork|plasterwork
punning|punning
ransacked|ransacked
officiously|officiously
upsweep|upsweep
impaled|impaled
organisational|organisational
dogmatics|dogmatics
faggy|faggy
drifted|drifted
misspeak|misspeak
refit|refit
sniffling|sniffling
reimposition|reimposition
gob|gob
decile|decile
disembarkation|disembarkation
turtledove|turtledove
triploid|triploid
vanload|vanload
caricatural|caricatural
coccus|coccus
beaky|beaky
probing|probing
surfeit|surfeit
nailer|nailer
phlogiston|phlogiston
microcode|microcode
bioregional|bioregional
sacralization|sacralization
subsidizing|subsidizing
unspecialized|unspecialized
oysterman|oysterman
typicality|typicality
cig|cig
refurnish|refurnish
dissembler|dissembler
krater|krater
breading|breading
agglutination|agglutination
Linnean|Linnean
quarreling|quarreling
kleptomaniac|kleptomaniac
sapwood|sapwood
conventionalism|conventionalism
patenting|patenting
monological|monological
unpresidential|unpresidential
behavioristic|behavioristic
foetus|foetus
leukaemia|leukaemia
orneriness|orneriness
bummed|bummed
unmodulated|unmodulated
jazzed|jazzed
singable|singable
inextinguishable|inextinguishable
sleepwear|sleepwear
robbin|robbin
interdict|interdict
Scythian|Scythian
peroneal|peroneal
Appian|Appian
Moldavian|Moldavian
seismological|seismological
checkable|checkable
unexpurgated|unexpurgated
odiferous|odiferous
hollowing|hollowing
profiteer|profiteer
fussbudget|fussbudget
ricocheting|ricocheting
egotistic|egotistic
metacarpal|metacarpal
erasing|erasing
reveller|reveller
unsaddled|unsaddled
destruct|destruct
entrapped|entrapped
dusting|dusting
coloristic|coloristic
limpness|limpness
adenovirus|adenovirus
drogue|drogue
callaloo|callaloo
assessable|assessable
unhelpfully|unhelpfully
wickedest|wickedest
indefatigably|indefatigably
casbah|casbah
foreseeably|foreseeably
purple|purple
tickertape|tickertape
hoaxer|hoaxer
keratosis|keratosis
quadrilateral|quadrilateral
sawbones|sawbones
sandblasting|sandblasting
Pompeian|Pompeian
mochi|mochi
bitching|bitching
embryogenesis|embryogenesis
loquat|loquat
subsumption|subsumption
riskless|riskless
greaseless|greaseless
Irishwoman|Irishwoman
purebred|purebred
haziness|haziness
rubberneck|rubberneck
redolence|redolence
resplendently|resplendently
knapweed|knapweed
adverbial|adverbial
homie|homie
desalinated|desalinated
hypostatic|hypostatic
pizzicato|pizzicato
milling|milling
dropsy|dropsy
clawfoot|clawfoot
euchre|euchre
recrudescence|recrudescence
handclasp|handclasp
syndicalist|syndicalist
scrapple|scrapple
nonordinary|nonordinary
chalcedony|chalcedony
pretentiously|pretentiously
shortening|shortening
baled|baled
suffused|suffused
presto|presto
medical|medical
souring|souring
jammy|jammy
diagnostically|diagnostically
imbricate|imbricate
orang|orang
polonaise|polonaise
intercostal|intercostal
epizootic|epizootic
schnozz|schnozz
sherlock|sherlock
bridgework|bridgework
coasting|coasting
corporative|corporative
Portugese|Portugese
bradycardia|bradycardia
defrosted|defrosted
agarose|agarose
pakora|pakora
pachysandra|pachysandra
potentilla|potentilla
dominus|dominus
odynophagia|odynophagia
tanka|tanka
metrically|metrically
ungraspable|ungraspable
mannitol|mannitol
peri|peri
demagogy|demagogy
biographic|biographic
Dustbuster|Dustbuster
eagle|eagle
instate|instate
museology|museology
decolonized|decolonized
mainstreaming|mainstreaming
detectability|detectability
titmouse|titmouse
verbalized|verbalized
respirable|respirable
demineralization|demineralization
circumciser|circumciser
furball|furball
fictionally|fictionally
behavioralist|behavioralist
evensong|evensong
fluorite|fluorite
scripturally|scripturally
cordial|cordial
snigger|snigger
redly|redly
polyandry|polyandry
aneurism|aneurism
virilocal|virilocal
glial|glial
curtainless|curtainless
Amharic|Amharic
anguishing|anguishing
susurration|susurration
groats|groats
interphone|interphone
faecal|faecal
perfuse|perfuse
transmittance|transmittance
ujamaa|ujamaa
inequitably|inequitably
spaced|spaced
hassled|hassled
rationalist|rationalist
moonshot|moonshot
uninstalled|uninstalled
hyoid|hyoid
metaleptic|metaleptic
limeade|limeade
medlar|medlar
hypercholesterolemia|hypercholesterolemia
arithmetically|arithmetically
onanism|onanism
tinware|tinware
prostituted|prostituted
Thracian|Thracian
evaluable|evaluable
patrilateral|patrilateral
mariculture|mariculture
supergun|supergun
tondo|tondo
sparker|sparker
bantering|bantering
slipknot|slipknot
tambour|tambour
hypotensive|hypotensive
friary|friary
electrophysiologist|electrophysiologist
fermionic|fermionic
newspeak|newspeak
magnifico|magnifico
asynchronously|asynchronously
satiated|satiated
wainscot|wainscot
hygroscopic|hygroscopic
volute|volute
palfrey|palfrey
transcriptional|transcriptional
misogynous|misogynous
marguerite|marguerite
repellency|repellency
silversides|silversides
mandamus|mandamus
hydrogel|hydrogel
radiometric|radiometric
enucleation|enucleation
enuresis|enuresis
lightship|lightship
squeezebox|squeezebox
malleolus|malleolus
dysthymia|dysthymia
bricoleur|bricoleur
physiographic|physiographic
electronystagmography|electronystagmography
intermolecular|intermolecular
provenience|provenience
pietistic|pietistic
Heian|Heian
tunica|tunica
wingspread|wingspread
deckle|deckle
regenerating|regenerating
leveraging|leveraging
paracetamol|paracetamol
nuclide|nuclide
plaice|plaice
economistic|economistic
hypercapnia|hypercapnia
albinism|albinism
kilocalorie|kilocalorie
glissade|glissade
princedom|princedom
askari|askari
architected|architected
roily|roily
purposiveness|purposiveness
redistributional|redistributional
bibliographer|bibliographer
kirtle|kirtle
polltaker|polltaker
preapproval|preapproval
genotypic|genotypic
teff|teff
stromatolite|stromatolite
hypomania|hypomania
hemiplegia|hemiplegia
ostium|ostium
childe|childe
embryonal|embryonal
ingrain|ingrain
crus|crus
rata|rata
mucociliary|mucociliary
pyrolysis|pyrolysis
guilloche|guilloche
benne|benne
carabinero|carabinero
esophagitis|esophagitis
relator|relator
torr|torr
uncaused|uncaused
enjambment|enjambment
interiorly|interiorly
kopje|kopje
preclusion|preclusion
egad|egad
compacting|compacting
haredi|haredi
heterojunction|heterojunction
synesthetic|synesthetic
braillewriter|braillewriter
transfrontier|transfrontier
cyanobacterial|cyanobacterial
orthomolecular|orthomolecular
scaffolded|scaffolded
stative|stative
krait|krait
endomorph|endomorph
millenarian|millenarian
serostatus|serostatus
microswitch|microswitch
halloo|halloo
precordial|precordial
benthos|benthos
telescreen|telescreen
internode|internode
nonworker|nonworker
splenectomy|splenectomy
uniformitarian|uniformitarian
pastorale|pastorale
perianth|perianth
implicature|implicature
onchocerciasis|onchocerciasis
contador|contador
denormalized|denormalized
tremolite|tremolite
scotoma|scotoma
destructor|destructor
anthropoid|anthropoid
myasthenia|myasthenia
nonsterile|nonsterile
colectomy|colectomy
reishi|reishi
bazar|bazar
goniometric|goniometric
deafened|deafened
anhydride|anhydride
debilitative|debilitative
holloware|holloware
anorectal|anorectal
accentual|accentual
picador|picador
agentry|agentry
berried|berried
demonstrability|demonstrability
broadtail|broadtail
jackscrew|jackscrew
